İmparatoriçe Laseen	<b>İmparatoriçe Laseen</b><br>Malazan İmparatorluğu'nun hükümdarı<br><hr style="border: 7px solid green; width:20%; margin-left:0;"></hr><br><i>Malazanlar</i><br><i>Karakterler</i>
Laseen	<b>İmparatoriçe Laseen</b><br>Malazan İmparatorluğu'nun hükümdarı<br><hr style="border: 7px solid green; width:20%; margin-left:0;"></hr><br><i>Malazanlar</i><br><i>Karakterler</i>
İmparatoriçe	<b>İmparatoriçe Laseen</b><br>Malazan İmparatorluğu'nun hükümdarı<br><hr style="border: 7px solid green; width:20%; margin-left:0;"></hr><br><i>Malazanlar</i><br><i>Karakterler</i>
Muavin Tavore	<b>Muavin Tavore</b><br>On Dördüncü Ordu komutanı<br><hr style="border: 7px solid green; width:20%; margin-left:0;"></hr><br><i>Malazanlar</i><br><i>Karakterler</i>
Muavin	<b>Muavin Tavore</b><br>On Dördüncü Ordu komutanı<br><hr style="border: 7px solid green; width:20%; margin-left:0;"></hr><br><i>Malazanlar</i><br><i>Karakterler</i>
Tavore	<b>Muavin Tavore</b><br>On Dördüncü Ordu komutanı<br><hr style="border: 7px solid green; width:20%; margin-left:0;"></hr><br><i>Malazanlar</i><br><i>Karakterler</i>
Yumruk Keneb	<b>Yumruk Keneb</b><br>tümen komutanı<br><hr style="border: 7px solid green; width:20%; margin-left:0;"></hr><br><i>Malazanlar</i><br><i>Karakterler</i>
Keneb	<b>Yumruk Keneb</b><br>tümen komutanı<br><hr style="border: 7px solid green; width:20%; margin-left:0;"></hr><br><i>Malazanlar</i><br><i>Karakterler</i>
Yumruk Blistig	<b>Yumruk Blistig</b><br>tümen komutanı<br><hr style="border: 7px solid green; width:20%; margin-left:0;"></hr><br><i>Malazanlar</i><br><i>Karakterler</i>
Blistig	<b>Yumruk Blistig</b><br>tümen komutanı<br><hr style="border: 7px solid green; width:20%; margin-left:0;"></hr><br><i>Malazanlar</i><br><i>Karakterler</i>
Yumruk Tene Baralta	<b>Yumruk Tene Baralta</b><br>tümen komutanı<br><hr style="border: 7px solid green; width:20%; margin-left:0;"></hr><br><i>Malazanlar</i><br><i>Karakterler</i>
Tene	<b>Yumruk Tene Baralta</b><br>tümen komutanı<br><hr style="border: 7px solid green; width:20%; margin-left:0;"></hr><br><i>Malazanlar</i><br><i>Karakterler</i>
Baralta	<b>Yumruk Tene Baralta</b><br>tümen komutanı<br><hr style="border: 7px solid green; width:20%; margin-left:0;"></hr><br><i>Malazanlar</i><br><i>Karakterler</i>
Tene Baralta	<b>Yumruk Tene Baralta</b><br>tümen komutanı<br><hr style="border: 7px solid green; width:20%; margin-left:0;"></hr><br><i>Malazanlar</i><br><i>Karakterler</i>
Yumruk Temul	<b>Yumruk Temul</b><br>tümen komutanı<br><hr style="border: 7px solid green; width:20%; margin-left:0;"></hr><br><i>Malazanlar</i><br><i>Karakterler</i>
Temul	<b>Yumruk Temul</b><br>tümen komutanı<br><hr style="border: 7px solid green; width:20%; margin-left:0;"></hr><br><i>Malazanlar</i><br><i>Karakterler</i>
Nil	bir Wickan bağcısı<br><hr style="border: 7px solid green; width:20%; margin-left:0;"></hr><br><i>Malazanlar</i><br><i>Karakterler</i>
Nether	bir Wickan cadısı<br><hr style="border: 7px solid green; width:20%; margin-left:0;"></hr><br><i>Malazanlar</i><br><i>Karakterler</i>
T'amber	Tavore'un yaveri<br><hr style="border: 7px solid green; width:20%; margin-left:0;"></hr><br><i>Malazanlar</i><br><i>Karakterler</i>
Lostara Yil	İnci'nin yaveri<br><hr style="border: 7px solid green; width:20%; margin-left:0;"></hr><br><i>Malazanlar</i><br><i>Karakterler</i>
Yil	İnci'nin yaveri<br><hr style="border: 7px solid green; width:20%; margin-left:0;"></hr><br><i>Malazanlar</i><br><i>Karakterler</i>
Lostara	İnci'nin yaveri<br><hr style="border: 7px solid green; width:20%; margin-left:0;"></hr><br><i>Malazanlar</i><br><i>Karakterler</i>
İnci	<i>(Pearl)</i><br>bir Pençe<br><hr style="border: 7px solid green; width:20%; margin-left:0;"></hr><br><i>Malazanlar</i><br><i>Karakterler</i>
Nok	İmparatorluk Filosu Amirali<br><hr style="border: 7px solid green; width:20%; margin-left:0;"></hr><br><i>Malazanlar</i><br><i>Karakterler</i>
Banaschar	eski bir D'rek rahibi<br><hr style="border: 7px solid green; width:20%; margin-left:0;"></hr><br><i>Malazanlar</i><br><i>Karakterler</i>
Hellian	Kartool şehir inzibatında bir çavuş<br><hr style="border: 7px solid green; width:20%; margin-left:0;"></hr><br><i>Malazanlar</i><br><i>Karakterler</i>
Urb	Kartool'da bir şehir inzibatı<br><hr style="border: 7px solid green; width:20%; margin-left:0;"></hr><br><i>Malazanlar</i><br><i>Karakterler</i>
Soluksuz	<i>(Breathless)</i><br>Kartool'da bir şehir inzibatı<br><hr style="border: 7px solid green; width:20%; margin-left:0;"></hr><br><i>Malazanlar</i><br><i>Karakterler</i>
Alıngan	<i>(Touchy)</i><br>Kartool'da bir şehir inzibatı<br><hr style="border: 7px solid green; width:20%; margin-left:0;"></hr><br><i>Malazanlar</i><br><i>Karakterler</i>
Tez Ben	<b>Tez Ben</b><br>On Dördüncü Ordu'da Baş Büyücü<br><hr style="border: 7px solid green; width:20%; margin-left:0;"></hr><br><i>Malazanlar</i><br><i>Karakterler</i>
Ben	<b>Tez Ben</b><br>On Dördüncü Ordu'da Baş Büyücü<br><hr style="border: 7px solid green; width:20%; margin-left:0;"></hr><br><i>Malazanlar</i><br><i>Karakterler</i>
Tez	<b>Tez Ben</b><br>On Dördüncü Ordu'da Baş Büyücü<br><hr style="border: 7px solid green; width:20%; margin-left:0;"></hr><br><i>Malazanlar</i><br><i>Karakterler</i>
Kalam Mekhar	<b>Kalam Mekhar</b><br>bir suikastçı<br><hr style="border: 7px solid green; width:20%; margin-left:0;"></hr><br><i>Malazanlar</i><br><i>Karakterler</i>
Kalam	<b>Kalam Mekhar</b><br>bir suikastçı<br><hr style="border: 7px solid green; width:20%; margin-left:0;"></hr><br><i>Malazanlar</i><br><i>Karakterler</i>
Mekhar	<b>Kalam Mekhar</b><br>bir suikastçı<br><hr style="border: 7px solid green; width:20%; margin-left:0;"></hr><br><i>Malazanlar</i><br><i>Karakterler</i>
Kurtçuk	<i>(Grub)</i><br>bir evlatlık
Yüzbaşı Sevecen	<b>Yüzbaşı Sevecen</b><br><i>(Kindly)</i><br>Ashok Alayı<br><hr style="border: 7px solid green; width:20%; margin-left:0;"></hr><br><i>On Dördüncü Ordu'da Belli Başlı Askerler</i><br><i>Karakterler</i>
Sevecen	<b>Yüzbaşı Sevecen</b><br><i>(Kindly)</i><br>Ashok Alayı<br><hr style="border: 7px solid green; width:20%; margin-left:0;"></hr><br><i>On Dördüncü Ordu'da Belli Başlı Askerler</i><br><i>Karakterler</i>
Teğmen Pores	<b>Teğmen Pores</b><br>Ashok Alayı<br><hr style="border: 7px solid green; width:20%; margin-left:0;"></hr><br><i>On Dördüncü Ordu'da Belli Başlı Askerler</i><br><i>Karakterler</i>
Pores	<b>Teğmen Pores</b><br>Ashok Alayı<br><hr style="border: 7px solid green; width:20%; margin-left:0;"></hr><br><i>On Dördüncü Ordu'da Belli Başlı Askerler</i><br><i>Karakterler</i>
Yüzbaşı Faradan Sort	<b>Yüzbaşı Faradan Sort</b><br><hr style="border: 7px solid green; width:20%; margin-left:0;"></hr><br><i>On Dördüncü Ordu'da Belli Başlı Askerler</i><br><i>Karakterler</i>
Faradan	<b>Yüzbaşı Faradan Sort</b><br><hr style="border: 7px solid green; width:20%; margin-left:0;"></hr><br><i>On Dördüncü Ordu'da Belli Başlı Askerler</i><br><i>Karakterler</i>
Sort	<b>Yüzbaşı Faradan Sort</b><br><hr style="border: 7px solid green; width:20%; margin-left:0;"></hr><br><i>On Dördüncü Ordu'da Belli Başlı Askerler</i><br><i>Karakterler</i>
Çavuş Kemancı / Teller	<b>Çavuş Kemancı / Teller</b><br><hr style="border: 7px solid green; width:20%; margin-left:0;"></hr><br><i>On Dördüncü Ordu'da Belli Başlı Askerler</i><br><i>Karakterler</i>
Çavuş Kemancı	<b>Çavuş Kemancı / Teller</b><br><hr style="border: 7px solid green; width:20%; margin-left:0;"></hr><br><i>On Dördüncü Ordu'da Belli Başlı Askerler</i><br><i>Karakterler</i>
Çavuş Teller	<b>Çavuş Kemancı / Teller</b><br><hr style="border: 7px solid green; width:20%; margin-left:0;"></hr><br><i>On Dördüncü Ordu'da Belli Başlı Askerler</i><br><i>Karakterler</i>
Kemancı	<b>Çavuş Kemancı / Teller</b><br><hr style="border: 7px solid green; width:20%; margin-left:0;"></hr><br><i>On Dördüncü Ordu'da Belli Başlı Askerler</i><br><i>Karakterler</i>
Teller	<b>Çavuş Kemancı / Teller</b><br><hr style="border: 7px solid green; width:20%; margin-left:0;"></hr><br><i>On Dördüncü Ordu'da Belli Başlı Askerler</i><br><i>Karakterler</i>
Onbaşı Katran	<b>Onbaşı Katran</b><br><i>(Tarr)</i><br><hr style="border: 7px solid green; width:20%; margin-left:0;"></hr><br><i>On Dördüncü Ordu'da Belli Başlı Askerler</i><br><i>Karakterler</i>
Katran	<b>Onbaşı Katran</b><br><i>(Tarr)</i><br><hr style="border: 7px solid green; width:20%; margin-left:0;"></hr><br><i>On Dördüncü Ordu'da Belli Başlı Askerler</i><br><i>Karakterler</i>
Huysuz	<i>(Cuttle)</i><br><hr style="border: 7px solid green; width:20%; margin-left:0;"></hr><br><i>On Dördüncü Ordu'da Belli Başlı Askerler</i><br><i>Karakterler</i>
Şişe	<i>(Bottle)</i><br><hr style="border: 7px solid green; width:20%; margin-left:0;"></hr><br><i>On Dördüncü Ordu'da Belli Başlı Askerler</i><br><i>Karakterler</i>
Koryk	<br><hr style="border: 7px solid green; width:20%; margin-left:0;"></hr><br><i>On Dördüncü Ordu'da Belli Başlı Askerler</i><br><i>Karakterler</i>
Gülücük	<i>(Smiles)</i><br><hr style="border: 7px solid green; width:20%; margin-left:0;"></hr><br><i>On Dördüncü Ordu'da Belli Başlı Askerler</i><br><i>Karakterler</i>
Çavuş Gesler	<b>Çavuş Gesler</b><br><hr style="border: 7px solid green; width:20%; margin-left:0;"></hr><br><i>On Dördüncü Ordu'da Belli Başlı Askerler</i><br><i>Karakterler</i>
Gesler	<b>Çavuş Gesler</b><br><hr style="border: 7px solid green; width:20%; margin-left:0;"></hr><br><i>On Dördüncü Ordu'da Belli Başlı Askerler</i><br><i>Karakterler</i>
Onbaşı Bulutlu	<b>Onbaşı Bulutlu</b><br><i>(Stormy)</i><br><hr style="border: 7px solid green; width:20%; margin-left:0;"></hr><br><i>On Dördüncü Ordu'da Belli Başlı Askerler</i><br><i>Karakterler</i>
Bulutlu	<b>Onbaşı Bulutlu</b><br><i>(Stormy)</i><br><hr style="border: 7px solid green; width:20%; margin-left:0;"></hr><br><i>On Dördüncü Ordu'da Belli Başlı Askerler</i><br><i>Karakterler</i>
Başçavuş Mert Diş	<b>Başçavuş Mert Diş</b><br><i>(Braven Tooth)</i><br><hr style="border: 7px solid green; width:20%; margin-left:0;"></hr><br><i>On Dördüncü Ordu'da Belli Başlı Askerler</i><br><i>Karakterler</i>
Mert Diş	<b>Başçavuş Mert Diş</b><br><i>(Braven Tooth)</i><br><hr style="border: 7px solid green; width:20%; margin-left:0;"></hr><br><i>On Dördüncü Ordu'da Belli Başlı Askerler</i><br><i>Karakterler</i>
Mert	<b>Başçavuş Mert Diş</b><br><i>(Braven Tooth)</i><br><hr style="border: 7px solid green; width:20%; margin-left:0;"></hr><br><i>On Dördüncü Ordu'da Belli Başlı Askerler</i><br><i>Karakterler</i>
Belki	<i>(Maybe)</i><br><hr style="border: 7px solid green; width:20%; margin-left:0;"></hr><br><i>On Dördüncü Ordu'da Belli Başlı Askerler</i><br><i>Karakterler</i>
Kopuzcu	<i>(Lutes)</i><br><hr style="border: 7px solid green; width:20%; margin-left:0;"></hr><br><i>On Dördüncü Ordu'da Belli Başlı Askerler</i><br><i>Karakterler</i>
Ebron	<br><hr style="border: 7px solid green; width:20%; margin-left:0;"></hr><br><i>On Dördüncü Ordu'da Belli Başlı Askerler</i><br><i>Karakterler</i>
Sinn	<br><hr style="border: 7px solid green; width:20%; margin-left:0;"></hr><br><i>On Dördüncü Ordu'da Belli Başlı Askerler</i><br><i>Karakterler</i>
Kırıntı	<i>(Crump)</i><br><hr style="border: 7px solid green; width:20%; margin-left:0;"></hr><br><i>On Dördüncü Ordu'da Belli Başlı Askerler</i><br><i>Karakterler</i>
Çavuş Merhem	<b>Çavuş Merhem</b><br><i>(Balm)</i><br><hr style="border: 7px solid green; width:20%; margin-left:0;"></hr><br><i>On Dördüncü Ordu'da Belli Başlı Askerler</i><br><i>Karakterler</i>
Merhem	<b>Çavuş Merhem</b><br><i>(Balm)</i><br><hr style="border: 7px solid green; width:20%; margin-left:0;"></hr><br><i>On Dördüncü Ordu'da Belli Başlı Askerler</i><br><i>Karakterler</i>
Onbaşı Ölükoku	<b>Onbaşı Ölükoku</b><br><i>(Deadsmell)</i><br><hr style="border: 7px solid green; width:20%; margin-left:0;"></hr><br><i>On Dördüncü Ordu'da Belli Başlı Askerler</i><br><i>Karakterler</i>
Ölükoku	<b>Onbaşı Ölükoku</b><br><i>(Deadsmell)</i><br><hr style="border: 7px solid green; width:20%; margin-left:0;"></hr><br><i>On Dördüncü Ordu'da Belli Başlı Askerler</i><br><i>Karakterler</i>
Gırtlakkesen	<i>(Throatslitter)</i><br><hr style="border: 7px solid green; width:20%; margin-left:0;"></hr><br><i>On Dördüncü Ordu'da Belli Başlı Askerler</i><br><i>Karakterler</i>
Masan Gilani	<b>Masan Gilani</b><br><hr style="border: 7px solid green; width:20%; margin-left:0;"></hr><br><i>On Dördüncü Ordu'da Belli Başlı Askerler</i><br><i>Karakterler</i>
Gilani	<b>Masan Gilani</b><br><hr style="border: 7px solid green; width:20%; margin-left:0;"></hr><br><i>On Dördüncü Ordu'da Belli Başlı Askerler</i><br><i>Karakterler</i>
Masan	<b>Masan Gilani</b><br><hr style="border: 7px solid green; width:20%; margin-left:0;"></hr><br><i>On Dördüncü Ordu'da Belli Başlı Askerler</i><br><i>Karakterler</i>
Barathol Mekhar	<b>Barathol Mekhar</b><br>bir demirci<br><hr style="border: 7px solid green; width:20%; margin-left:0;"></hr><br><i>Ötekiler</i><br><i>Karakterler</i>
Barathol	<b>Barathol Mekhar</b><br>bir demirci<br><hr style="border: 7px solid green; width:20%; margin-left:0;"></hr><br><i>Ötekiler</i><br><i>Karakterler</i>
Kulat	bir köylü<br><hr style="border: 7px solid green; width:20%; margin-left:0;"></hr><br><i>Ötekiler</i><br><i>Karakterler</i>
Nulliss	bir köylü<br><hr style="border: 7px solid green; width:20%; margin-left:0;"></hr><br><i>Ötekiler</i><br><i>Karakterler</i>
Hayrith	bir köylü<br><hr style="border: 7px solid green; width:20%; margin-left:0;"></hr><br><i>Ötekiler</i><br><i>Karakterler</i>
Chaur	bir köylü<br><hr style="border: 7px solid green; width:20%; margin-left:0;"></hr><br><i>Ötekiler</i><br><i>Karakterler</i>
Noto Çıban	<b>Noto Çıban</b><br>Tekkol'un Ordusu'nda bölük baytarı (şifacısı)<br><hr style="border: 7px solid green; width:20%; margin-left:0;"></hr><br><i>Ötekiler</i><br><i>Karakterler</i>
Noto	<b>Noto Çıban</b><br>Tekkol'un Ordusu'nda bölük baytarı (şifacısı)<br><hr style="border: 7px solid green; width:20%; margin-left:0;"></hr><br><i>Ötekiler</i><br><i>Karakterler</i>
Çıban	<b>Noto Çıban</b><br>Tekkol'un Ordusu'nda bölük baytarı (şifacısı)<br><hr style="border: 7px solid green; width:20%; margin-left:0;"></hr><br><i>Ötekiler</i><br><i>Karakterler</i>
Hurlochel	Tekkol'un Ordusu'nda bir muhrip<br><hr style="border: 7px solid green; width:20%; margin-left:0;"></hr><br><i>Ötekiler</i><br><i>Karakterler</i>
Yüzbaşı Tatlıdere	<b></b><br><i>(Sweetcreek)</i><br>Tekkol'un Ordusu'nda bir subay<br><hr style="border: 7px solid green; width:20%; margin-left:0;"></hr><br><i>Ötekiler</i><br><i>Karakterler</i>
Tatlıdere	<b></b><br><i>(Sweetcreek)</i><br>Tekkol'un Ordusu'nda bir subay<br><hr style="border: 7px solid green; width:20%; margin-left:0;"></hr><br><i>Ötekiler</i><br><i>Karakterler</i>
Onbaşı Futhgar	<b>Onbaşı Futhgar</b><br>Tekkol'un Ordusu'nda bir subay<br><hr style="border: 7px solid green; width:20%; margin-left:0;"></hr><br><i>Ötekiler</i><br><i>Karakterler</i>
Futhgar	<b>Onbaşı Futhgar</b><br>Tekkol'un Ordusu'nda bir subay<br><hr style="border: 7px solid green; width:20%; margin-left:0;"></hr><br><i>Ötekiler</i><br><i>Karakterler</i>
Yumruk Rythe Bude	<b>Yumruk Rythe Bude</b><br>Tekkol'un Ordusu'nda bir subay Ormulogun	ressam<br><hr style="border: 7px solid green; width:20%; margin-left:0;"></hr><br><i>Ötekiler</i><br><i>Karakterler</i>
Rythe	<b>Yumruk Rythe Bude</b><br>Tekkol'un Ordusu'nda bir subay Ormulogun	ressam<br><hr style="border: 7px solid green; width:20%; margin-left:0;"></hr><br><i>Ötekiler</i><br><i>Karakterler</i>
Bude	<b>Yumruk Rythe Bude</b><br>Tekkol'un Ordusu'nda bir subay Ormulogun	ressam<br><hr style="border: 7px solid green; width:20%; margin-left:0;"></hr><br><i>Ötekiler</i><br><i>Karakterler</i>
Gumble	Yumruk Rythe Bude'un eleştirmeni<br><hr style="border: 7px solid green; width:20%; margin-left:0;"></hr><br><i>Ötekiler</i><br><i>Karakterler</i>
Apsalar	bir suikastçı<br><hr style="border: 7px solid green; width:20%; margin-left:0;"></hr><br><i>Ötekiler</i><br><i>Karakterler</i>
Telorast	bir ruh<br><hr style="border: 7px solid green; width:20%; margin-left:0;"></hr><br><i>Ötekiler</i><br><i>Karakterler</i>
Kaymak	<i>(Curdle)</i><br>bir ruh<br><hr style="border: 7px solid green; width:20%; margin-left:0;"></hr><br><i>Ötekiler</i><br><i>Karakterler</i>
Samar Dav	<b>Samar Dav</b><br>bir Ugarat cadısı<br><hr style="border: 7px solid green; width:20%; margin-left:0;"></hr><br><i>Ötekiler</i><br><i>Karakterler</i>
Samar	<b>Samar Dav</b><br>bir Ugarat cadısı<br><hr style="border: 7px solid green; width:20%; margin-left:0;"></hr><br><i>Ötekiler</i><br><i>Karakterler</i>
Dav	<b>Samar Dav</b><br>bir Ugarat cadısı<br><hr style="border: 7px solid green; width:20%; margin-left:0;"></hr><br><i>Ötekiler</i><br><i>Karakterler</i>
Karsa Orlong	<b>Karsa Orlong</b><br>bir Teblor savaşçı<br><hr style="border: 7px solid green; width:20%; margin-left:0;"></hr><br><i>Ötekiler</i><br><i>Karakterler</i>
Karsa	<b>Karsa Orlong</b><br>bir Teblor savaşçı<br><hr style="border: 7px solid green; width:20%; margin-left:0;"></hr><br><i>Ötekiler</i><br><i>Karakterler</i>
Orlong	<b>Karsa Orlong</b><br>bir Teblor savaşçı<br><hr style="border: 7px solid green; width:20%; margin-left:0;"></hr><br><i>Ötekiler</i><br><i>Karakterler</i>
Ganath	bir Jaghut<br><hr style="border: 7px solid green; width:20%; margin-left:0;"></hr><br><i>Ötekiler</i><br><i>Karakterler</i>
Garez	<i>(Spite)</i><br>bir Tektutan ve Leydi Gıpta'nın kız kardeşi<br><hr style="border: 7px solid green; width:20%; margin-left:0;"></hr><br><i>Ötekiler</i><br><i>Karakterler</i>
Corabb Bhilan Thenu'alas	<b>Corabb Bhilan Thenu'alas</b><br><br><hr style="border: 7px solid green; width:20%; margin-left:0;"></hr><br><i>Ötekiler</i><br><i>Karakterler</i>
Corabb	<b>Corabb Bhilan Thenu'alas</b><br><br><hr style="border: 7px solid green; width:20%; margin-left:0;"></hr><br><i>Ötekiler</i><br><i>Karakterler</i>
Bhilan	<b>Corabb Bhilan Thenu'alas</b><br><br><hr style="border: 7px solid green; width:20%; margin-left:0;"></hr><br><i>Ötekiler</i><br><i>Karakterler</i>
Thenu'alas	<b>Corabb Bhilan Thenu'alas</b><br><br><hr style="border: 7px solid green; width:20%; margin-left:0;"></hr><br><i>Ötekiler</i><br><i>Karakterler</i>
Gürzlü Leoman	<b>Gürzlü Leoman</b><br>isyanın son lideri<br><hr style="border: 7px solid green; width:20%; margin-left:0;"></hr><br><i>Ötekiler</i><br><i>Karakterler</i>
Gürzlü	<b>Gürzlü Leoman</b><br>isyanın son lideri<br><hr style="border: 7px solid green; width:20%; margin-left:0;"></hr><br><i>Ötekiler</i><br><i>Karakterler</i>
Leoman	<b>Gürzlü Leoman</b><br>isyanın son lideri<br><hr style="border: 7px solid green; width:20%; margin-left:0;"></hr><br><i>Ötekiler</i><br><i>Karakterler</i>
Yüzbaşı Bozserçe	<b>Yüzbaşı Bozserçe</b><br><i>(Dunsparrow)</i><br>Y'Ghatan şehir inzibatı<br><hr style="border: 7px solid green; width:20%; margin-left:0;"></hr><br><i>Ötekiler</i><br><i>Karakterler</i>
Bozserçe	<b>Yüzbaşı Bozserçe</b><br><i>(Dunsparrow)</i><br>Y'Ghatan şehir inzibatı<br><hr style="border: 7px solid green; width:20%; margin-left:0;"></hr><br><i>Ötekiler</i><br><i>Karakterler</i>
Karpolan Demesand	<b>Karpolan Demesand</b><br>Trygalle Ticaret Loncası<br><hr style="border: 7px solid green; width:20%; margin-left:0;"></hr><br><i>Ötekiler</i><br><i>Karakterler</i>
Demesand	<b>Karpolan Demesand</b><br>Trygalle Ticaret Loncası<br><hr style="border: 7px solid green; width:20%; margin-left:0;"></hr><br><i>Ötekiler</i><br><i>Karakterler</i>
Karpolan	<b>Karpolan Demesand</b><br>Trygalle Ticaret Loncası<br><hr style="border: 7px solid green; width:20%; margin-left:0;"></hr><br><i>Ötekiler</i><br><i>Karakterler</i>
Torahaval Delat	<b>Torahaval Delat</b><br>bir Poliel rahibesi<br><hr style="border: 7px solid green; width:20%; margin-left:0;"></hr><br><i>Ötekiler</i><br><i>Karakterler</i>
Delat	<b>Torahaval Delat</b><br>bir Poliel rahibesi<br><hr style="border: 7px solid green; width:20%; margin-left:0;"></hr><br><i>Ötekiler</i><br><i>Karakterler</i>
Torahaval	<b>Torahaval Delat</b><br>bir Poliel rahibesi<br><hr style="border: 7px solid green; width:20%; margin-left:0;"></hr><br><i>Ötekiler</i><br><i>Karakterler</i>
Kesici	<i>(Cutter)</i><br>eskiden Darujhistanlı Crokus<br><hr style="border: 7px solid green; width:20%; margin-left:0;"></hr><br><i>Ötekiler</i><br><i>Karakterler</i>
Heboric Hayalet Eller	<b>Heboric Hayalet Eller</b><br>Treach Destriyanı<br><hr style="border: 7px solid green; width:20%; margin-left:0;"></hr><br><i>Ötekiler</i><br><i>Karakterler</i>
Heboric	<b>Heboric Hayalet Eller</b><br>Treach Destriyanı<br><hr style="border: 7px solid green; width:20%; margin-left:0;"></hr><br><i>Ötekiler</i><br><i>Karakterler</i>
Scillara	Rarakulu sığınmacı<br><hr style="border: 7px solid green; width:20%; margin-left:0;"></hr><br><i>Ötekiler</i><br><i>Karakterler</i>
Genç Felisin	<b>Genç Felisin</b><br>Rarakulu sığınmacı<br><hr style="border: 7px solid green; width:20%; margin-left:0;"></hr><br><i>Ötekiler</i><br><i>Karakterler</i>
Felisin	<b>Genç Felisin</b><br>Rarakulu sığınmacı<br><hr style="border: 7px solid green; width:20%; margin-left:0;"></hr><br><i>Ötekiler</i><br><i>Karakterler</i>
Grikurbağa	<i>(Greyfrog)</i><br>bir iblis<br><hr style="border: 7px solid green; width:20%; margin-left:0;"></hr><br><i>Ötekiler</i><br><i>Karakterler</i>
Mappo Runt	<b>Mappo Runt</b><br>bir Trell<br><hr style="border: 7px solid green; width:20%; margin-left:0;"></hr><br><i>Ötekiler</i><br><i>Karakterler</i>
Mappo	<b>Mappo Runt</b><br>bir Trell<br><hr style="border: 7px solid green; width:20%; margin-left:0;"></hr><br><i>Ötekiler</i><br><i>Karakterler</i>
Runt	<b>Mappo Runt</b><br>bir Trell<br><hr style="border: 7px solid green; width:20%; margin-left:0;"></hr><br><i>Ötekiler</i><br><i>Karakterler</i>
Icarium	bir Jhag<br><hr style="border: 7px solid green; width:20%; margin-left:0;"></hr><br><i>Ötekiler</i><br><i>Karakterler</i>
Iskaral Pust	<b>Iskaral Pust</b><br>bir Gölge rahibi<br><hr style="border: 7px solid green; width:20%; margin-left:0;"></hr><br><i>Ötekiler</i><br><i>Karakterler</i>
Iskaral	<b>Iskaral Pust</b><br>bir Gölge rahibi<br><hr style="border: 7px solid green; width:20%; margin-left:0;"></hr><br><i>Ötekiler</i><br><i>Karakterler</i>
Pust	<b>Iskaral Pust</b><br>bir Gölge rahibi<br><hr style="border: 7px solid green; width:20%; margin-left:0;"></hr><br><i>Ötekiler</i><br><i>Karakterler</i>
Mogora	bir D'iver<br><hr style="border: 7px solid green; width:20%; margin-left:0;"></hr><br><i>Ötekiler</i><br><i>Karakterler</i>
Taralack Veed	<b>Taralack Veed</b><br>bir Gral ve İsimsizler'in bir ajanı<br><hr style="border: 7px solid green; width:20%; margin-left:0;"></hr><br><i>Ötekiler</i><br><i>Karakterler</i>
Taralack	<b>Taralack Veed</b><br>bir Gral ve İsimsizler'in bir ajanı<br><hr style="border: 7px solid green; width:20%; margin-left:0;"></hr><br><i>Ötekiler</i><br><i>Karakterler</i>
Veed	<b>Taralack Veed</b><br>bir Gral ve İsimsizler'in bir ajanı<br><hr style="border: 7px solid green; width:20%; margin-left:0;"></hr><br><i>Ötekiler</i><br><i>Karakterler</i>
Dejim Nebrahil	<b>Dejim Nebrahil</b><br>İlk İmparatorluk'tan bir D'iver T'rolbarahl<br><hr style="border: 7px solid green; width:20%; margin-left:0;"></hr><br><i>Ötekiler</i><br><i>Karakterler</i>
Dejim	<b>Dejim Nebrahil</b><br>İlk İmparatorluk'tan bir D'iver T'rolbarahl<br><hr style="border: 7px solid green; width:20%; margin-left:0;"></hr><br><i>Ötekiler</i><br><i>Karakterler</i>
Nebrahil	<b>Dejim Nebrahil</b><br>İlk İmparatorluk'tan bir D'iver T'rolbarahl<br><hr style="border: 7px solid green; width:20%; margin-left:0;"></hr><br><i>Ötekiler</i><br><i>Karakterler</i>
Trull Sengar	<b>Trull Sengar</b><br>bir Tiste Edur<br><hr style="border: 7px solid green; width:20%; margin-left:0;"></hr><br><i>Ötekiler</i><br><i>Karakterler</i>
Trull	<b>Trull Sengar</b><br>bir Tiste Edur<br><hr style="border: 7px solid green; width:20%; margin-left:0;"></hr><br><i>Ötekiler</i><br><i>Karakterler</i>
Sengar	<b>Trull Sengar</b><br>bir Tiste Edur<br><hr style="border: 7px solid green; width:20%; margin-left:0;"></hr><br><i>Ötekiler</i><br><i>Karakterler</i>
Bitik Onrack	<b>Bitik Onrack</b><br>bağını koparmış bir T'lan Imass<br><hr style="border: 7px solid green; width:20%; margin-left:0;"></hr><br><i>Ötekiler</i><br><i>Karakterler</i>
Bitik	<b>Bitik Onrack</b><br>bağını koparmış bir T'lan Imass<br><hr style="border: 7px solid green; width:20%; margin-left:0;"></hr><br><i>Ötekiler</i><br><i>Karakterler</i>
Onrack	<b>Bitik Onrack</b><br>bağını koparmış bir T'lan Imass<br><hr style="border: 7px solid green; width:20%; margin-left:0;"></hr><br><i>Ötekiler</i><br><i>Karakterler</i>
Ibra Gholan	<b>Ibra Gholan</b><br>bir T'lan Imass<br><hr style="border: 7px solid green; width:20%; margin-left:0;"></hr><br><i>Ötekiler</i><br><i>Karakterler</i>
Ibra	<b>Ibra Gholan</b><br>bir T'lan Imass<br><hr style="border: 7px solid green; width:20%; margin-left:0;"></hr><br><i>Ötekiler</i><br><i>Karakterler</i> Gholan	<b>Ibra Gholan</b><br>bir T'lan Imass<br><hr style="border: 7px solid green; width:20%; margin-left:0;"></hr><br><i>Ötekiler</i><br><i>Karakterler</i>
Monok Ochem	<b>Monok Ochem</b><br>bir T'lan Imass Kemikbakar<br><hr style="border: 7px solid green; width:20%; margin-left:0;"></hr><br><i>Ötekiler</i><br><i>Karakterler</i>
Monok	<b>Monok Ochem</b><br>bir T'lan Imass Kemikbakar<br><hr style="border: 7px solid green; width:20%; margin-left:0;"></hr><br><i>Ötekiler</i><br><i>Karakterler</i>
Ochem	<b>Monok Ochem</b><br>bir T'lan Imass Kemikbakar<br><hr style="border: 7px solid green; width:20%; margin-left:0;"></hr><br><i>Ötekiler</i><br><i>Karakterler</i>
Minala	Gölge Bölüğü komutanı<br><hr style="border: 7px solid green; width:20%; margin-left:0;"></hr><br><i>Ötekiler</i><br><i>Karakterler</i>
Tomad Sengar	<b>Tomad Sengar</b><br>bir Tiste Edur<br><hr style="border: 7px solid green; width:20%; margin-left:0;"></hr><br><i>Ötekiler</i><br><i>Karakterler</i>
Tomad	<b>Tomad Sengar</b><br>bir Tiste Edur<br><hr style="border: 7px solid green; width:20%; margin-left:0;"></hr><br><i>Ötekiler</i><br><i>Karakterler</i>
Sengar	<b>Tomad Sengar</b><br>bir Tiste Edur<br><hr style="border: 7px solid green; width:20%; margin-left:0;"></hr><br><i>Ötekiler</i><br><i>Karakterler</i>
Tüy Cadı	<b>Tüy Cadı</b><br>bir Letherii köle<br><hr style="border: 7px solid green; width:20%; margin-left:0;"></hr><br><i>Ötekiler</i><br><i>Karakterler</i>
Atri—Preda Yan Tovis	<b>Atri—Preda Yan Tovis</b><br><i>(Tan [Twilight])</i><br>Letherii kuvvetleri komutanı<br><hr style="border: 7px solid green; width:20%; margin-left:0;"></hr><br><i>Ötekiler</i><br><i>Karakterler</i>
Atri—Preda	<b>Atri—Preda Yan Tovis</b><br><i>(Tan [Twilight])</i><br>Letherii kuvvetleri komutanı<br><hr style="border: 7px solid green; width:20%; margin-left:0;"></hr><br><i>Ötekiler</i><br><i>Karakterler</i>
Yan	<b>Atri—Preda Yan Tovis</b><br><i>(Tan [Twilight])</i><br>Letherii kuvvetleri komutanı<br><hr style="border: 7px solid green; width:20%; margin-left:0;"></hr><br><i>Ötekiler</i><br><i>Karakterler</i>
Tovis	<b>Atri—Preda Yan Tovis</b><br><i>(Tan [Twilight])</i><br>Letherii kuvvetleri komutanı<br><hr style="border: 7px solid green; width:20%; margin-left:0;"></hr><br><i>Ötekiler</i><br><i>Karakterler</i>
Yüzbaşı Varat Taun	<b>Yüzbaşı Varat Taun</b><br>Tan'ın Komutası'nda subay<br><hr style="border: 7px solid green; width:20%; margin-left:0;"></hr><br><i>Ötekiler</i><br><i>Karakterler</i>
Taun	<b>Yüzbaşı Varat Taun</b><br>Tan'ın Komutası'nda subay<br><hr style="border: 7px solid green; width:20%; margin-left:0;"></hr><br><i>Ötekiler</i><br><i>Karakterler</i>
Varat Taun	<b>Yüzbaşı Varat Taun</b><br>Tan'ın Komutası'nda subay<br><hr style="border: 7px solid green; width:20%; margin-left:0;"></hr><br><i>Ötekiler</i><br><i>Karakterler</i>
Varat	<b>Yüzbaşı Varat Taun</b><br>Tan'ın Komutası'nda subay<br><hr style="border: 7px solid green; width:20%; margin-left:0;"></hr><br><i>Ötekiler</i><br><i>Karakterler</i>
Taxilian	bir tercüman<br><hr style="border: 7px solid green; width:20%; margin-left:0;"></hr><br><i>Ötekiler</i><br><i>Karakterler</i>
Ahlrada Ahn	<b>Ahlrada Ahn</b><br>Tiste Edurlar arasında bir Tiste Andii casusu<br><hr style="border: 7px solid green; width:20%; margin-left:0;"></hr><br><i>Ötekiler</i><br><i>Karakterler</i>
Ahlrada	<b>Ahlrada Ahn</b><br>Tiste Edurlar arasında bir Tiste Andii casusu<br><hr style="border: 7px solid green; width:20%; margin-left:0;"></hr><br><i>Ötekiler</i><br><i>Karakterler</i>
Ahn	<b>Ahlrada Ahn</b><br>Tiste Edurlar arasında bir Tiste Andii casusu<br><hr style="border: 7px solid green; width:20%; margin-left:0;"></hr><br><i>Ötekiler</i><br><i>Karakterler</i>
Sathbaro Rangar	<b>Sathbaro Rangar</b><br>Arapay bağcısı<br><hr style="border: 7px solid green; width:20%; margin-left:0;"></hr><br><i>Ötekiler</i><br><i>Karakterler</i>
Sathbaro	<b>Sathbaro Rangar</b><br>Arapay bağcısı<br><hr style="border: 7px solid green; width:20%; margin-left:0;"></hr><br><i>Ötekiler</i><br><i>Karakterler</i>
Rangar	<b>Sathbaro Rangar</b><br>Arapay bağcısı<br><hr style="border: 7px solid green; width:20%; margin-left:0;"></hr><br><i>Ötekiler</i><br><i>Karakterler</i>
Anomander Rake	<b>Anomander Rake</b><br>Karanlığın Oğlu<br><hr style="border: 7px solid green; width:20%; margin-left:0;"></hr><br><i>Ermişler</i><br><i>Sözlük</i>
Anomander	<b>Anomander Rake</b><br>Karanlığın Oğlu<br><hr style="border: 7px solid green; width:20%; margin-left:0;"></hr><br><i>Ermişler</i><br><i>Sözlük</i>
Rake	<b>Anomander Rake</b><br>Karanlığın Oğlu<br><hr style="border: 7px solid green; width:20%; margin-left:0;"></hr><br><i>Ermişler</i><br><i>Sözlük</i>
Apsalar	Hırsızlar Leydisi<br><hr style="border: 7px solid green; width:20%; margin-left:0;"></hr><br><i>Ermişler</i><br><i>Sözlük</i>
Azathlar	Haneler<br><hr style="border: 7px solid green; width:20%; margin-left:0;"></hr><br><i>Ermişler</i><br><i>Sözlük</i>
Beru	Fırtınalar Lordu<br><hr style="border: 7px solid green; width:20%; margin-left:0;"></hr><br><i>Ermişler</i><br><i>Sözlük</i>
Burn	Uyuyan Tanrıça<br><hr style="border: 7px solid green; width:20%; margin-left:0;"></hr><br><i>Ermişler</i><br><i>Sözlük</i>
D'rek	kâh dişi kâh erkek olarak tapılan Güz Solucanı<br><hr style="border: 7px solid green; width:20%; margin-left:0;"></hr><br><i>Ermişler</i><br><i>Sözlük</i>
Deragothlar	Dessimbelackis İlk İmparatorluğu'ndan, Karanlığın Yedi Tazısı<br><hr style="border: 7px solid green; width:20%; margin-left:0;"></hr><br><i>Ermişler</i><br><i>Sözlük</i>
Dessembrae	Gözyaşları Lordu<br><hr style="border: 7px solid green; width:20%; margin-left:0;"></hr><br><i>Ermişler</i><br><i>Sözlük</i>
Draconus	bir Ata Tanrı ve Dragnipur kılıcının üreticisi<br><hr style="border: 7px solid green; width:20%; margin-left:0;"></hr><br><i>Ermişler</i><br><i>Sözlük</i>
Düşler Kraliçesi	Yaşam Üst Hanesi Kraliçesi<br><hr style="border: 7px solid green; width:20%; margin-left:0;"></hr><br><i>Ermişler</i><br><i>Sözlük</i>
Eres/Eres'al	<b>Eres/Eres'al</b><br>bir cet ruh/tanrıça<br><hr style="border: 7px solid green; width:20%; margin-left:0;"></hr><br><i>Ermişler</i><br><i>Sözlük</i>
Eres	<b>Eres/Eres'al</b><br>bir cet ruh/tanrıça<br><hr style="border: 7px solid green; width:20%; margin-left:0;"></hr><br><i>Ermişler</i><br><i>Sözlük</i>
Eres'al	<b>Eres/Eres'al</b><br>bir cet ruh/tanrıça<br><hr style="border: 7px solid green; width:20%; margin-left:0;"></hr><br><i>Ermişler</i><br><i>Sözlük</i>
Fener	Mahrum, Beş Dişli Yaban Domuzu<br><hr style="border: 7px solid green; width:20%; margin-left:0;"></hr><br><i>Ermişler</i><br><i>Sözlük</i>
Gedderone	Bahar ve Yeniden Doğuş Leydisi<br><hr style="border: 7px solid green; width:20%; margin-left:0;"></hr><br><i>Ermişler</i><br><i>Sözlük</i>
Gölgetaht	Ammanas, Gölge Üst Hanesi Kralı<br><hr style="border: 7px solid green; width:20%; margin-left:0;"></hr><br><i>Ermişler</i><br><i>Sözlük</i>
Grizzin Farl	<b>Grizzin Farl</b><br>bir Ata Tanrı<br><hr style="border: 7px solid green; width:20%; margin-left:0;"></hr><br><i>Ermişler</i><br><i>Sözlük</i>
Grizzin	<b>Grizzin Farl</b><br>bir Ata Tanrı<br><hr style="border: 7px solid green; width:20%; margin-left:0;"></hr><br><i>Ermişler</i><br><i>Sözlük</i>
Farl	<b>Grizzin Farl</b><br>bir Ata Tanrı<br><hr style="border: 7px solid green; width:20%; margin-left:0;"></hr><br><i>Ermişler</i><br><i>Sözlük</i>
Hood	Ölüm Üst Hanesi Kralı<br><hr style="border: 7px solid green; width:20%; margin-left:0;"></hr><br><i>Ermişler</i><br><i>Sözlük</i>
Jhess	Dokumanın Kraliçesi<br><hr style="border: 7px solid green; width:20%; margin-left:0;"></hr><br><i>Ermişler</i><br><i>Sözlük</i>
K'rul	bir Kovanlar Ata Tanrısı<br><hr style="border: 7px solid green; width:20%; margin-left:0;"></hr><br><i>Ermişler</i><br><i>Sözlük</i>
Kilmandaros	bir Ata Tanrı<br><hr style="border: 7px solid green; width:20%; margin-left:0;"></hr><br><i>Ermişler</i><br><i>Sözlük</i>
Karanlığın Yedi Tazısı	<br><hr style="border: 7px solid green; width:20%; margin-left:0;"></hr><br><i>Ermişler</i><br><i>Sözlük</i>
Kotilyon	Urgan, Suikastçılar Hamisi, Gölge Üst Hanesi<br><hr style="border: 7px solid green; width:20%; margin-left:0;"></hr><br><i>Ermişler</i><br><i>Sözlük</i>
Köprüyakarlar	<br><hr style="border: 7px solid green; width:20%; margin-left:0;"></hr><br><i>Ermişler</i><br><i>Sözlük</i>
Mael	bir Denizler Ata Tanrısı<br><hr style="border: 7px solid green; width:20%; margin-left:0;"></hr><br><i>Ermişler</i><br><i>Sözlük</i>
Mowri	Dilenciler, Köleler ve Irgatlar Leydisi<br><hr style="border: 7px solid green; width:20%; margin-left:0;"></hr><br><i>Ermişler</i><br><i>Sözlük</i>
Nerruse	Sakin Denizler ve Elverişli Rüzgârlar Leydisi<br><hr style="border: 7px solid green; width:20%; margin-left:0;"></hr><br><i>Ermişler</i><br><i>Sözlük</i>
Oponn	Şansın İkiz Maskaraları<br><hr style="border: 7px solid green; width:20%; margin-left:0;"></hr><br><i>Ermişler</i><br><i>Sözlük</i>
Osserc	<b>Osserc/Osseric/Osric</b><br>Göğün Lordu<br><hr style="border: 7px solid green; width:20%; margin-left:0;"></hr><br><i>Ermişler</i><br><i>Sözlük</i>
Osseric	<b>Osserc/Osseric/Osric</b><br>Göğün Lordu<br><hr style="border: 7px solid green; width:20%; margin-left:0;"></hr><br><i>Ermişler</i><br><i>Sözlük</i>
Osric	<b>Osserc/Osseric/Osric</b><br>Göğün Lordu<br><hr style="border: 7px solid green; width:20%; margin-left:0;"></hr><br><i>Ermişler</i><br><i>Sözlük</i>
Poliel	Salgınlar ve Hastalıklar Hanımı<br><hr style="border: 7px solid green; width:20%; margin-left:0;"></hr><br><i>Ermişler</i><br><i>Sözlük</i>
Sakat Tanrı	Zincire Vurulmuş, Zincirler Üst Hanesi Lordu<br><hr style="border: 7px solid green; width:20%; margin-left:0;"></hr><br><i>Ermişler</i><br><i>Sözlük</i>
Scalissara	Y'Ghatan'a hükmeden gözden düşmüş bir zeytinyağı tanrıçası<br><hr style="border: 7px solid green; width:20%; margin-left:0;"></hr><br><i>Ermişler</i><br><i>Sözlük</i>
Sha'ik	Hortum Tanrıça<br><hr style="border: 7px solid green; width:20%; margin-left:0;"></hr><br><i>Ermişler</i><br><i>Sözlük</i>
Soğuk Geceler Bacısı	bir Ata Tanrıça<br><hr style="border: 7px solid green; width:20%; margin-left:0;"></hr><br><i>Ermişler</i><br><i>Sözlük</i>
Soliel	Sıhhat Leydisi<br><hr style="border: 7px solid green; width:20%; margin-left:0;"></hr><br><i>Ermişler</i><br><i>Sözlük</i>
Togg	<b>Togg ve Fanderay</b><br>Kış Kurtları<br><hr style="border: 7px solid green; width:20%; margin-left:0;"></hr><br><i>Ermişler</i><br><i>Sözlük</i>
Fanderay	<b>Togg ve Fanderay</b><br>Kış Kurtları<br><hr style="border: 7px solid green; width:20%; margin-left:0;"></hr><br><i>Ermişler</i><br><i>Sözlük</i>
Treach	<b>Treach/Trake</b><br>Yaz Kaplanı ve Savaş Lordu<br><hr style="border: 7px solid green; width:20%; margin-left:0;"></hr><br><i>Ermişler</i><br><i>Sözlük</i>
Trake	<b>Treach/Trake</b><br>Yaz Kaplanı ve Savaş Lordu<br><hr style="border: 7px solid green; width:20%; margin-left:0;"></hr><br><i>Ermişler</i><br><i>Sözlük</i>
Tiste Andii	Karanlığın Çocukları<br><hr style="border: 7px solid green; width:20%; margin-left:0;"></hr><br><i>Ata Irklar</i><br><i>Sözlük</i>
Tiste Edur	Gölgenin Çocukları<br><hr style="border: 7px solid green; width:20%; margin-left:0;"></hr><br><i>Ata Irklar</i><br><i>Sözlük</i>
Tiste Liosan	Işığın Çocukları<br><hr style="border: 7px solid green; width:20%; margin-left:0;"></hr><br><i>Ata Irklar</i><br><i>Sözlük</i>
Kurald Galain	Karanlığın Ata Kovanı<br><hr style="border: 7px solid green; width:20%; margin-left:0;"></hr><br><i>Kovanlar</i><br><i>Sözlük</i>
Kurald Emurlahn	Gölgenin Ata Kovanı, Kırık Kovan<br><hr style="border: 7px solid green; width:20%; margin-left:0;"></hr><br><i>Kovanlar</i><br><i>Sözlük</i>
Kurald Liosan	<br><hr style="border: 7px solid green; width:20%; margin-left:0;"></hr><br><i>Kovanlar</i><br><i>Sözlük</i>
Kurald Thyrllan	Işığın Ata Kovanı<br><hr style="border: 7px solid green; width:20%; margin-left:0;"></hr><br><i>Kovanlar</i><br><i>Sözlük</i>
Omtose Phellack	Buzun Jaghut Ata Kovanı<br><hr style="border: 7px solid green; width:20%; margin-left:0;"></hr><br><i>Kovanlar</i><br><i>Sözlük</i>
Tellann	Ateşin Imass Ata Kovanı<br><hr style="border: 7px solid green; width:20%; margin-left:0;"></hr><br><i>Kovanlar</i><br><i>Sözlük</i>
Starvald Demelain	Eleint Kovanı<br><hr style="border: 7px solid green; width:20%; margin-left:0;"></hr><br><i>Kovanlar</i><br><i>Sözlük</i>
Thyr	Işığın Yolu<br><hr style="border: 7px solid green; width:20%; margin-left:0;"></hr><br><i>Kovanlar</i><br><i>Sözlük</i>
Denul	Şifanın Yolu<br><hr style="border: 7px solid green; width:20%; margin-left:0;"></hr><br><i>Kovanlar</i><br><i>Sözlük</i>
Hood'un Yolu	Ölümün Yolu<br><hr style="border: 7px solid green; width:20%; margin-left:0;"></hr><br><i>Kovanlar</i><br><i>Sözlük</i>
Serc	Göğün Yolu<br><hr style="border: 7px solid green; width:20%; margin-left:0;"></hr><br><i>Kovanlar</i><br><i>Sözlük</i>
Meanas	Gölgenin ve İllüzyonun Yolu<br><hr style="border: 7px solid green; width:20%; margin-left:0;"></hr><br><i>Kovanlar</i><br><i>Sözlük</i>
D'riss	Toprağın Yolu<br><hr style="border: 7px solid green; width:20%; margin-left:0;"></hr><br><i>Kovanlar</i><br><i>Sözlük</i>
Ruse	Denizin Yolu<br><hr style="border: 7px solid green; width:20%; margin-left:0;"></hr><br><i>Kovanlar</i><br><i>Sözlük</i>
Rashan	Karanlığın Yolu<br><hr style="border: 7px solid green; width:20%; margin-left:0;"></hr><br><i>Kovanlar</i><br><i>Sözlük</i>
Mockra	Zihnin Yolu<br><hr style="border: 7px solid green; width:20%; margin-left:0;"></hr><br><i>Kovanlar</i><br><i>Sözlük</i>
Telas	Ateşin Yolu<br><hr style="border: 7px solid green; width:20%; margin-left:0;"></hr><br><i>Kovanlar</i><br><i>Sözlük</i>
Anibar	Yedi Kent'teki, Jhag Odhan'ın kuzeyindeki Kalkan topraklarda yaşayan bir kabile<br><hr style="border: 7px solid green; width:20%; margin-left:0;"></hr><br><i>Kişiler ve Yerler</i><br><i>Sözlük</i>
Ehrlitan	Yedi Kent'te bir liman şehri<br><hr style="border: 7px solid green; width:20%; margin-left:0;"></hr><br><i>Kişiler ve Yerler</i><br><i>Sözlük</i>
G'danisban	Yedi Kent'te bir şehir<br><hr style="border: 7px solid green; width:20%; margin-left:0;"></hr><br><i>Kişiler ve Yerler</i><br><i>Sözlük</i>
Gral	bir Yedi Kent kabilesi<br><hr style="border: 7px solid green; width:20%; margin-left:0;"></hr><br><i>Kişiler ve Yerler</i><br><i>Sözlük</i>
Hanar Ara	kadim bir şehir, Düşkünler Şehri<br><hr style="border: 7px solid green; width:20%; margin-left:0;"></hr><br><i>Kişiler ve Yerler</i><br><i>Sözlük</i>
Hatra	Yedi Kent'te bir şehir<br><hr style="border: 7px solid green; width:20%; margin-left:0;"></hr><br><i>Kişiler ve Yerler</i><br><i>Sözlük</i>
Hedori Kwil	Yedi Kent'te ortadan kalkmış bir şehir<br><hr style="border: 7px solid green; width:20%; margin-left:0;"></hr><br><i>Kişiler ve Yerler</i><br><i>Sözlük</i>
Inath'an Mersin	Yedi Kent şehri Mersin'in eski adı<br><hr style="border: 7px solid green; width:20%; margin-left:0;"></hr><br><i>Kişiler ve Yerler</i><br><i>Sözlük</i>
Kanarbar Belid	Yedi Kent şehri Belid'in eski adı<br><hr style="border: 7px solid green; width:20%; margin-left:0;"></hr><br><i>Kişiler ve Yerler</i><br><i>Sözlük</i>
Karashimesh	Yedi Kent'te bir şehir<br><hr style="border: 7px solid green; width:20%; margin-left:0;"></hr><br><i>Kişiler ve Yerler</i><br><i>Sözlük</i>
Kartool	Quon Tali anakarasının açıklarında bir şehir ve ada<br><hr style="border: 7px solid green; width:20%; margin-left:0;"></hr><br><i>Kişiler ve Yerler</i><br><i>Sözlük</i>
Kuzgun Tepe Parkı	Malaz Kent'te bir park<br><hr style="border: 7px solid green; width:20%; margin-left:0;"></hr><br><i>Kişiler ve Yerler</i><br><i>Sözlük</i>
Malaz Kent	Quon Tali anakarasının açıklarındaki Malaz Adası'nda Malazan İmparatorluğu'nun doğum yeri.<br><hr style="border: 7px solid green; width:20%; margin-left:0;"></hr><br><i>Kişiler ve Yerler</i><br><i>Sözlük</i>
Minikenar	Yedi Kent'te İlk İmparatorluk'a ait ortadan kalkmış bir şehir<br><hr style="border: 7px solid green; width:20%; margin-left:0;"></hr><br><i>Kişiler ve Yerler</i><br><i>Sözlük</i>
Mock'un Kalesi	Malaz Kent'te tepeden bakan eski kale<br><hr style="border: 7px solid green; width:20%; margin-left:0;"></hr><br><i>Kişiler ve Yerler</i><br><i>Sözlük</i>
Monkan	Sepik'in kardeş adası (daha küçük)<br><hr style="border: 7px solid green; width:20%; margin-left:0;"></hr><br><i>Kişiler ve Yerler</i><br><i>Sözlük</i>
N'Karaphal	Yedi Kent'te ortadan kalkmış bir şehir<br><hr style="border: 7px solid green; width:20%; margin-left:0;"></hr><br><i>Kişiler ve Yerler</i><br><i>Sözlük</i>
Nemil	Jhag Odhan'ın kuzeybatısında yayılmacı bir krallık<br><hr style="border: 7px solid green; width:20%; margin-left:0;"></hr><br><i>Kişiler ve Yerler</i><br><i>Sözlük</i>
Pan'potsun	Yedi Kent'te bir şehir<br><hr style="border: 7px solid green; width:20%; margin-left:0;"></hr><br><i>Kişiler ve Yerler</i><br><i>Sözlük</i>
Pardu	bir Yedi Kent kabilesi<br><hr style="border: 7px solid green; width:20%; margin-left:0;"></hr><br><i>Kişiler ve Yerler</i><br><i>Sözlük</i>
Perish	Nemil'in batısında bir krallık<br><hr style="border: 7px solid green; width:20%; margin-left:0;"></hr><br><i>Kişiler ve Yerler</i><br><i>Sözlük</i>
Sepik Adası	Yedi Kent'te bir ada krallığı<br><hr style="border: 7px solid green; width:20%; margin-left:0;"></hr><br><i>Kişiler ve Yerler</i><br><i>Sözlük</i>
Septark Semti	Kartool Kent'in tapınak semti<br><hr style="border: 7px solid green; width:20%; margin-left:0;"></hr><br><i>Kişiler ve Yerler</i><br><i>Sözlük</i>
Shal—Morzinn	Nemil'in güneybatısında bir imparatorluk<br><hr style="border: 7px solid green; width:20%; margin-left:0;"></hr><br><i>Kişiler ve Yerler</i><br><i>Sözlük</i>
Tahkimat Yolu	Malaz Kent'te Mock'un Kalesi'nden inen yokuş<br><hr style="border: 7px solid green; width:20%; margin-left:0;"></hr><br><i>Kişiler ve Yerler</i><br><i>Sözlük</i>
Tramara	Yedi Kent'te ortadan kalkmış bir şehir<br><hr style="border: 7px solid green; width:20%; margin-left:0;"></hr><br><i>Kişiler ve Yerler</i><br><i>Sözlük</i>
Trebur	Yedi Kent'te ortadan kalkmış bir şehir (Kubbeler Şehri)<br><hr style="border: 7px solid green; width:20%; margin-left:0;"></hr><br><i>Kişiler ve Yerler</i><br><i>Sözlük</i>
Ugarat	Yedi Kent'te bir şehir<br><hr style="border: 7px solid green; width:20%; margin-left:0;"></hr><br><i>Kişiler ve Yerler</i><br><i>Sözlük</i>
Vedanik	Yedi Kent'teki Tahalas Dağları'nda bir kabile<br><hr style="border: 7px solid green; width:20%; margin-left:0;"></hr><br><i>Kişiler ve Yerler</i><br><i>Sözlük</i>
Vinith	Yedi Kent'te ortadan kalkmış bir şehir<br><hr style="border: 7px solid green; width:20%; margin-left:0;"></hr><br><i>Kişiler ve Yerler</i><br><i>Sözlük</i>
Vithan Taur	Yedi Kent'te İlk İmparatorluk'a ait ortadan kalkmış bir şehir<br><hr style="border: 7px solid green; width:20%; margin-left:0;"></hr><br><i>Kişiler ve Yerler</i><br><i>Sözlük</i>
Y'Ghatan	Yedi Kent'te bir şehir<br><hr style="border: 7px solid green; width:20%; margin-left:0;"></hr><br><i>Kişiler ve Yerler</i><br><i>Sözlük</i>
Akik Sihirbazlar/Konsey	Mavigül'ün geleneksel hükümdarları<br><hr style="border: 7px solid green; width:20%; margin-left:0;"></hr><br><i>Tabirler</i><br><i>Sözlük</i>
Altınsaka	Yedi Kent'e özgü bir ağaç<br><hr style="border: 7px solid green; width:20%; margin-left:0;"></hr><br><i>Tabirler</i><br><i>Sözlük</i>
Aptorian	Gölge Âlem'e özgü bir iblis cinsi<br><hr style="border: 7px solid green; width:20%; margin-left:0;"></hr><br><i>Tabirler</i><br><i>Sözlük</i>
Ashok Alayı	artık On Dördüncü Ordu'ya dahil eski bir alay<br><hr style="border: 7px solid green; width:20%; margin-left:0;"></hr><br><i>Tabirler</i><br><i>Sözlük</i>
Atri—Preda	Letheriilerde Kumandan veya Yumruk dengi<br><hr style="border: 7px solid green; width:20%; margin-left:0;"></hr><br><i>Tabirler</i><br><i>Sözlük</i>
Azalan	Gölge Âlem'e özgü bir iblis cinsi<br><hr style="border: 7px solid green; width:20%; margin-left:0;"></hr><br><i>Tabirler</i><br><i>Sözlük</i>
Bhederin	iri, kısmen ehlileştirilmiş veya vahşi bir toynaklı hayvan<br><hr style="border: 7px solid green; width:20%; margin-left:0;"></hr><br><i>Tabirler</i><br><i>Sözlük</i>
Bhok'aral	kayalıklarda yaşayan küçük bir maymun cinsi<br><hr style="border: 7px solid green; width:20%; margin-left:0;"></hr><br><i>Tabirler</i><br><i>Sözlük</i>
Carelbarra	halüsinojenik özelliklerinden dolayı Tanrı Getiren adıyla da bilinen bir bal<br><hr style="border: 7px solid green; width:20%; margin-left:0;"></hr><br><i>Tabirler</i><br><i>Sözlük</i>
Çocuk Ölüm Şarkısı	Setilerde törensel defni de içeren bir yetişkinliğe geçiş âyini<br><hr style="border: 7px solid green; width:20%; margin-left:0;"></hr><br><i>Tabirler</i><br><i>Sözlük</i>
D'bayang	bir uyuşturucu<br><hr style="border: 7px solid green; width:20%; margin-left:0;"></hr><br><i>Tabirler</i><br><i>Sözlük</i>
D'iver	çok sayıda hayvana dönüşmeyi sağlayan bir şekil değiştirme türü<br><hr style="border: 7px solid green; width:20%; margin-left:0;"></hr><br><i>Tabirler</i><br><i>Sözlük</i>
Demidrek	bir D'rek başrahibi veya başrahibesi<br><hr style="border: 7px solid green; width:20%; margin-left:0;"></hr><br><i>Tabirler</i><br><i>Sözlük</i>
Destriyan	belirli bir dinin fâni temsilcisi<br><hr style="border: 7px solid green; width:20%; margin-left:0;"></hr><br><i>Tabirler</i><br><i>Sözlük</i>
Dinal	Gölge Âlem'de bir iblis cinsi<br><hr style="border: 7px solid green; width:20%; margin-left:0;"></hr><br><i>Tabirler</i><br><i>Sözlük</i>
Dromon	bir savaş gemisi<br><hr style="border: 7px solid green; width:20%; margin-left:0;"></hr><br><i>Tabirler</i><br><i>Sözlük</i>
Ejder	bir Tanno hac gemisi<br><hr style="border: 7px solid green; width:20%; margin-left:0;"></hr><br><i>Tabirler</i><br><i>Sözlük</i>
Ekin Piresi	Yedi Kent'te rüzgârlarla taşınan bir böcek<br><hr style="border: 7px solid green; width:20%; margin-left:0;"></hr><br><i>Tabirler</i><br><i>Sözlük</i>
Eleint	safkan ejderhaların diğer bir tabiri<br><hr style="border: 7px solid green; width:20%; margin-left:0;"></hr><br><i>Tabirler</i><br><i>Sözlük</i>
Enkar'al	Yedi Kent'te artık soyu tükenmiş iri bir yırtıcı<br><hr style="border: 7px solid green; width:20%; margin-left:0;"></hr><br><i>Tabirler</i><br><i>Sözlük</i>
Eraga	Yedi Kent'te soyunun tükendiği sanılan bir sığır türü<br><hr style="border: 7px solid green; width:20%; margin-left:0;"></hr><br><i>Tabirler</i><br><i>Sözlük</i>
Escura	ekin pirelerini öldürmekte kullanılan bir bitki<br><hr style="border: 7px solid green; width:20%; margin-left:0;"></hr><br><i>Tabirler</i><br><i>Sözlük</i>
Fâni Kılıç	bir tanrının askeri şampiyonu<br><hr style="border: 7px solid green; width:20%; margin-left:0;"></hr><br><i>Tabirler</i><br><i>Sözlük</i>
Fırtınabinerler	okyanusta yaşayan bir canlı türü<br><hr style="border: 7px solid green; width:20%; margin-left:0;"></hr><br><i>Tabirler</i><br><i>Sözlük</i>
Fırtınaduvar	Korel'de Fırtınabiner saldırılarına karşı bir bariyer<br><hr style="border: 7px solid green; width:20%; margin-left:0;"></hr><br><i>Tabirler</i><br><i>Sözlük</i>
Fısıltılar	Yeniden Doğmuş Sha'ik tarikatında yol gösterici sesler<br><hr style="border: 7px solid green; width:20%; margin-left:0;"></hr><br><i>Tabirler</i><br><i>Sözlük</i>
Gothar çiçeği	ağartıcı bir madde<br><hr style="border: 7px solid green; width:20%; margin-left:0;"></hr><br><i>Tabirler</i><br><i>Sözlük</i>
Gözcü	Lether Kıtası'ndaki Tiste Edurlar arasında saklanan bir Tiste Andii ajanı<br><hr style="border: 7px solid green; width:20%; margin-left:0;"></hr><br><i>Tabirler</i><br><i>Sözlük</i>
Gri Miğferler	askeri bir din nizamı<br><hr style="border: 7px solid green; width:20%; margin-left:0;"></hr><br><i>Tabirler</i><br><i>Sözlük</i>
Imbrules	Starvald Demelain'e özgü belirsiz bir hayvan<br><hr style="border: 7px solid green; width:20%; margin-left:0;"></hr><br><i>Tabirler</i><br><i>Sözlük</i>
İsimsizler	kendini Azath Hanelerine adamış kadim bir tarikat<br><hr style="border: 7px solid green; width:20%; margin-left:0;"></hr><br><i>Tabirler</i><br><i>Sözlük</i>
Jhistal	insan kanını âyinsel sihirde kullanan bir Ata Tanrının başrahibi<br><hr style="border: 7px solid green; width:20%; margin-left:0;"></hr><br><i>Tabirler</i><br><i>Sözlük</i>
Kalkan Örsü	kendini belirli bir tanrıya adamış düşkünlerin (ölenlerin) fâni muhafazası<br><hr style="border: 7px solid green; width:20%; margin-left:0;"></hr><br><i>Tabirler</i><br><i>Sözlük</i>
Kara Eldiven	Pençe dahilinde gizli bir tarikat<br><hr style="border: 7px solid green; width:20%; margin-left:0;"></hr><br><i>Tabirler</i><br><i>Sözlük</i>
Karatahta	Tiste Edurların kullandığı nadir bir tahta<br><hr style="border: 7px solid green; width:20%; margin-left:0;"></hr><br><i>Tabirler</i><br><i>Sözlük</i>
Kemikbakar	türlerinde şaman anlamına gelen bir T'lan Imass tabiri<br><hr style="border: 7px solid green; width:20%; margin-left:0;"></hr><br><i>Tabirler</i><br><i>Sözlük</i>
Kepgüve	Yedi Kent'te leş yiyen iri bir böcek<br><hr style="border: 7px solid green; width:20%; margin-left:0;"></hr><br><i>Tabirler</i><br><i>Sözlük</i>
Kethra bıçağı	Yedi Kent'te geniş yalımlı büyük bir bıçak<br><hr style="border: 7px solid green; width:20%; margin-left:0;"></hr><br><i>Tabirler</i><br><i>Sözlük</i>
Kısa—Kuyruklar	K'Chain Nah'ukların bir başka adı<br><hr style="border: 7px solid green; width:20%; margin-left:0;"></hr><br><i>Tabirler</i><br><i>Sözlük</i>
Koraval	Malaz Adası civarında en fazla yakalanan bir balık cinsi<br><hr style="border: 7px solid green; width:20%; margin-left:0;"></hr><br><i>Tabirler</i><br><i>Sözlük</i>
Luthuras	Starvald Demelain'e özgü belirsiz bir hayvan<br><hr style="border: 7px solid green; width:20%; margin-left:0;"></hr><br><i>Tabirler</i><br><i>Sözlük</i>
Maethgara	Y'Ghatan'da zeytinyağı depolamakta kullanılan binalara verilen ad<br><hr style="border: 7px solid green; width:20%; margin-left:0;"></hr><br><i>Tabirler</i><br><i>Sözlük</i>
Mahybe	kap anlamına gelen kadim tabir (Artık Rhiviler arasında Mhybe olarak bilinir)<br><hr style="border: 7px solid green; width:20%; margin-left:0;"></hr><br><i>Tabirler</i><br><i>Sözlük</i>
Meer—sıçan	Kertenkele bir kemirgen<br><hr style="border: 7px solid green; width:20%; margin-left:0;"></hr><br><i>Tabirler</i><br><i>Sözlük</i>
Obsidyen Taht	Mavigül'ün geleneksel güç merkezi<br><hr style="border: 7px solid green; width:20%; margin-left:0;"></hr><br><i>Tabirler</i><br><i>Sözlük</i>
Paralt	her ikisi de zehirli bir örümceğin ve bir yılanın (ve ayrıca zehirlerinin) adı<br><hr style="border: 7px solid green; width:20%; margin-left:0;"></hr><br><i>Tabirler</i><br><i>Sözlük</i>
Preda	Letheriilerde yüzbaşı rütbesi<br><hr style="border: 7px solid green; width:20%; margin-left:0;"></hr><br><i>Tabirler</i><br><i>Sözlük</i>
Purlith	Starvald Demelain'e özgü bir yarasa cinsi<br><hr style="border: 7px solid green; width:20%; margin-left:0;"></hr><br><i>Tabirler</i><br><i>Sözlük</i>
Rhizan	böcek yiyen ufak, kanatlı bir sürüngen<br><hr style="border: 7px solid green; width:20%; margin-left:0;"></hr><br><i>Tabirler</i><br><i>Sözlük</i>
Savaş Tahtları	Perishlilerin kullandıkları savaş katamaranlarının adı<br><hr style="border: 7px solid green; width:20%; margin-left:0;"></hr><br><i>Tabirler</i><br><i>Sözlük</i>
Stantars	Starvald Demelain'e özgü belirsiz bir hayvan<br><hr style="border: 7px solid green; width:20%; margin-left:0;"></hr><br><i>Tabirler</i><br><i>Sözlük</i>
T'rolbarahl	İlk İmparatorluk döneminden kalma kadim bir D'iver biçimi<br><hr style="border: 7px solid green; width:20%; margin-left:0;"></hr><br><i>Tabirler</i><br><i>Sözlük</i>
Taşıyıcı	bir veba yayıcısı<br><hr style="border: 7px solid green; width:20%; margin-left:0;"></hr><br><i>Tabirler</i><br><i>Sözlük</i>
Tektutan	şekil değiştirme<br><hr style="border: 7px solid green; width:20%; margin-left:0;"></hr><br><i>Tabirler</i><br><i>Sözlük</i>
Telaba	Yedi Kent'te giyilen geleneksel bir dış giysi<br><hr style="border: 7px solid green; width:20%; margin-left:0;"></hr><br><i>Tabirler</i><br><i>Sözlük</i>
Tetkikçiler	Trygalle Ticaret Loncası'nda haritacılar<br><hr style="border: 7px solid green; width:20%; margin-left:0;"></hr><br><i>Tabirler</i><br><i>Sözlük</i>
Trell Savaşları	Nemilliler tarafından Trell'lere karşı verilen soykırım savaşları<br><hr style="border: 7px solid green; width:20%; margin-left:0;"></hr><br><i>Tabirler</i><br><i>Sözlük</i>
Uzun—kuyruklar	K'Chain Che'Mallelerin bir başka adı<br><hr style="border: 7px solid green; width:20%; margin-left:0;"></hr><br><i>Tabirler</i><br><i>Sözlük</i>
Verdith'anath	Ölüm Köprüsü (Jaghut yeraltı dünyası)<br><hr style="border: 7px solid green; width:20%; margin-left:0;"></hr><br><i>Tabirler</i><br><i>Sözlük</i>
Yeminci	Ugarat'taki Kraliyet İşkencecisi'nin unvanı<br><hr style="border: 7px solid green; width:20%; margin-left:0;"></hr><br><i>Tabirler</i><br><i>Sözlük</i>
Yemlik	Malazanlar arasında popüler bir masa oyunu<br><hr style="border: 7px solid green; width:20%; margin-left:0;"></hr><br><i>Tabirler</i><br><i>Sözlük</i>
