Karsa Orlong	<b>Karsa Orlong</b><br>genç bir savaşçı<br><hr style="border: 7px solid green; width:20%; margin-left:0;"></hr><br><i>Teblorların Uryd Kabilesi</i><br><i>Karakterler</i>
Karsa	<b>Karsa Orlong</b><br>genç bir savaşçı<br><hr style="border: 7px solid green; width:20%; margin-left:0;"></hr><br><i>Teblorların Uryd Kabilesi</i><br><i>Karakterler</i>
Orlong	<b>Karsa Orlong</b><br>genç bir savaşçı<br><hr style="border: 7px solid green; width:20%; margin-left:0;"></hr><br><i>Teblorların Uryd Kabilesi</i><br><i>Karakterler</i>
Bairoth Gild	<b>Bairoth Gild</b><br>genç bir savaşçı<br><hr style="border: 7px solid green; width:20%; margin-left:0;"></hr><br><i>Teblorların Uryd Kabilesi</i><br><i>Karakterler</i>
Bairoth	<b>Bairoth Gild</b><br>genç bir savaşçı<br><hr style="border: 7px solid green; width:20%; margin-left:0;"></hr><br><i>Teblorların Uryd Kabilesi</i><br><i>Karakterler</i>
Gild	<b>Bairoth Gild</b><br>genç bir savaşçı<br><hr style="border: 7px solid green; width:20%; margin-left:0;"></hr><br><i>Teblorların Uryd Kabilesi</i><br><i>Karakterler</i>
Delum Thord	<b>Delum Thord</b><br>genç bir savaşçı<br><hr style="border: 7px solid green; width:20%; margin-left:0;"></hr><br><i>Teblorların Uryd Kabilesi</i><br><i>Karakterler</i>
Delum	<b>Delum Thord</b><br>genç bir savaşçı<br><hr style="border: 7px solid green; width:20%; margin-left:0;"></hr><br><i>Teblorların Uryd Kabilesi</i><br><i>Karakterler</i>
Thord	<b>Delum Thord</b><br>genç bir savaşçı<br><hr style="border: 7px solid green; width:20%; margin-left:0;"></hr><br><i>Teblorların Uryd Kabilesi</i><br><i>Karakterler</i>
Dayliss	<b>Dayliss</b><br>genç bir kadın<br><hr style="border: 7px solid green; width:20%; margin-left:0;"></hr><br><i>Teblorların Uryd Kabilesi</i><br><i>Karakterler</i>
Pahlk	<b>Pahlk</b><br>Karsa'nın dedesi<br><hr style="border: 7px solid green; width:20%; margin-left:0;"></hr><br><i>Teblorların Uryd Kabilesi</i><br><i>Karakterler</i>
Synyg	<b>Synyg</b><br>Karsa'nın babası<br><hr style="border: 7px solid green; width:20%; margin-left:0;"></hr><br><i>Teblorların Uryd Kabilesi</i><br><i>Karakterler</i>
Muavin Tavore	<b>Muavin Tavore</b><br><br><hr style="border: 7px solid green; width:20%; margin-left:0;"></hr><br><i>Muavin'in Ordusu</i><br><i>Karakterler</i>
Muavin	<b>Muavin Tavore</b><br><br><hr style="border: 7px solid green; width:20%; margin-left:0;"></hr><br><i>Muavin'in Ordusu</i><br><i>Karakterler</i>
Tavore	<b>Muavin Tavore</b><br><br><hr style="border: 7px solid green; width:20%; margin-left:0;"></hr><br><i>Muavin'in Ordusu</i><br><i>Karakterler</i>
Yumruk Gamet	<b>Yumruk Gamet/Gimlet</b><br><br><hr style="border: 7px solid green; width:20%; margin-left:0;"></hr><br><i>Muavin'in Ordusu</i><br><i>Karakterler</i>
Gamet	<b>Yumruk Gamet/Gimlet</b><br><br><hr style="border: 7px solid green; width:20%; margin-left:0;"></hr><br><i>Muavin'in Ordusu</i><br><i>Karakterler</i>
Gimlet	<b>Yumruk Gamet/Gimlet</b><br><br><hr style="border: 7px solid green; width:20%; margin-left:0;"></hr><br><i>Muavin'in Ordusu</i><br><i>Karakterler</i>
T'amber	<b>T'amber</b><br><br><hr style="border: 7px solid green; width:20%; margin-left:0;"></hr><br><i>Muavin'in Ordusu</i><br><i>Karakterler</i>
Yumruk Tene Baralta	<b>Yumruk Tene Baralta</b><br><br><hr style="border: 7px solid green; width:20%; margin-left:0;"></hr><br><i>Muavin'in Ordusu</i><br><i>Karakterler</i>
Tene	<b>Yumruk Tene Baralta</b><br><br><hr style="border: 7px solid green; width:20%; margin-left:0;"></hr><br><i>Muavin'in Ordusu</i><br><i>Karakterler</i>
Baralta	<b>Yumruk Tene Baralta</b><br><br><hr style="border: 7px solid green; width:20%; margin-left:0;"></hr><br><i>Muavin'in Ordusu</i><br><i>Karakterler</i>
Yumruk Blistig	<b>Yumruk Blistig</b><br><br><hr style="border: 7px solid green; width:20%; margin-left:0;"></hr><br><i>Muavin'in Ordusu</i><br><i>Karakterler</i>
Blistig	<b>Yumruk Blistig</b><br><br><hr style="border: 7px solid green; width:20%; margin-left:0;"></hr><br><i>Muavin'in Ordusu</i><br><i>Karakterler</i>
Yüzbaşı Keneb	<b>Yüzbaşı Keneb</b><br><br><hr style="border: 7px solid green; width:20%; margin-left:0;"></hr><br><i>Muavin'in Ordusu</i><br><i>Karakterler</i>
Keneb	<b>Yüzbaşı Keneb</b><br><br><hr style="border: 7px solid green; width:20%; margin-left:0;"></hr><br><i>Muavin'in Ordusu</i><br><i>Karakterler</i>
Kurtçuk	<b>Kurtçuk</b><br><i>Grub</i><br>onun evlatlık oğlu<br><hr style="border: 7px solid green; width:20%; margin-left:0;"></hr><br><i>Muavin'in Ordusu</i><br><i>Karakterler</i>
Amiral Nok	<b>Amiral Nok</b><br><br><hr style="border: 7px solid green; width:20%; margin-left:0;"></hr><br><i>Muavin'in Ordusu</i><br><i>Karakterler</i>
Nok	<b>Amiral Nok</b><br><br><hr style="border: 7px solid green; width:20%; margin-left:0;"></hr><br><i>Muavin'in Ordusu</i><br><i>Karakterler</i>
Binbaşı Alardis	<b>Binbaşı Alardis</b><br><br><hr style="border: 7px solid green; width:20%; margin-left:0;"></hr><br><i>Muavin'in Ordusu</i><br><i>Karakterler</i>
Alardis	<b>Binbaşı Alardis</b><br><br><hr style="border: 7px solid green; width:20%; margin-left:0;"></hr><br><i>Muavin'in Ordusu</i><br><i>Karakterler</i>
Nil	<b>Nil</b><br>bir Wickan bağcısı<br><hr style="border: 7px solid green; width:20%; margin-left:0;"></hr><br><i>Muavin'in Ordusu</i><br><i>Karakterler</i>
Nether	<b>Nether</b><br>bir Wickan cadısı<br><hr style="border: 7px solid green; width:20%; margin-left:0;"></hr><br><i>Muavin'in Ordusu</i><br><i>Karakterler</i>
Temul	<b>Temul</b><br>Karga Klanı'ndan bir Wickan, Köpekler Zinciri felaketzedesi<br><hr style="border: 7px solid green; width:20%; margin-left:0;"></hr><br><i>Muavin'in Ordusu</i><br><i>Karakterler</i>
Şaşı	<b>Şaşı</b><br><i>Squint</i><br>Aren İnzibatı'nda bir asker<br><hr style="border: 7px solid green; width:20%; margin-left:0;"></hr><br><i>Muavin'in Ordusu</i><br><i>Karakterler</i>
İnci	<b>İnci</b><br><i>Pearl</i><br>bir Pençe<br><hr style="border: 7px solid green; width:20%; margin-left:0;"></hr><br><i>Muavin'in Ordusu</i><br><i>Karakterler</i>
Lostara Yil	<b>Lostara Yil</b><br>Kızıl Kılıçlar'da bir subay<br><hr style="border: 7px solid green; width:20%; margin-left:0;"></hr><br><i>Muavin'in Ordusu</i><br><i>Karakterler</i>
Lostara	<b>Lostara Yil</b><br>Kızıl Kılıçlar'da bir subay<br><hr style="border: 7px solid green; width:20%; margin-left:0;"></hr><br><i>Muavin'in Ordusu</i><br><i>Karakterler</i>
Yil	<b>Lostara Yil</b><br>Kızıl Kılıçlar'da bir subay<br><hr style="border: 7px solid green; width:20%; margin-left:0;"></hr><br><i>Muavin'in Ordusu</i><br><i>Karakterler</i>
Gall	<b>Gall</b><br>Khundryl Yanık Gözyaşları'nda bir savaş reisi<br><hr style="border: 7px solid green; width:20%; margin-left:0;"></hr><br><i>Muavin'in Ordusu</i><br><i>Karakterler</i>
Imrahl	<b>Imrahl</b><br>Khundryl Yanık Gözyaşları'nda bir savaşçı<br><hr style="border: 7px solid green; width:20%; margin-left:0;"></hr><br><i>Muavin'in Ordusu</i><br><i>Karakterler</i>
Topper	<b>Topper</b><br>Pençebaşı<br><hr style="border: 7px solid green; width:20%; margin-left:0;"></hr><br><i>Muavin'in Ordusu</i><br><i>Karakterler</i>
Teğmen Ranal	<b>Teğmen Ranal</b><br><br><hr style="border: 7px solid green; width:20%; margin-left:0;"></hr><br><i>9. Bölük, 8. Lejyon Komandoları</i><br><i>Karakterler</i>
Ranal	<b>Teğmen Ranal</b><br><br><hr style="border: 7px solid green; width:20%; margin-left:0;"></hr><br><i>9. Bölük, 8. Lejyon Komandoları</i><br><i>Karakterler</i>
Çavuş Teller	<b>Çavuş Teller</b><br><i>Strings</i><br><br><hr style="border: 7px solid green; width:20%; margin-left:0;"></hr><br><i>9. Bölük, 8. Lejyon Komandoları</i><br><i>Karakterler</i>
Teller	<b>Çavuş Teller</b><br><i>Strings</i><br><br><hr style="border: 7px solid green; width:20%; margin-left:0;"></hr><br><i>9. Bölük, 8. Lejyon Komandoları</i><br><i>Karakterler</i>
Çavuş Gesler	<b>Çavuş Gesler</b><br><br><hr style="border: 7px solid green; width:20%; margin-left:0;"></hr><br><i>9. Bölük, 8. Lejyon Komandoları</i><br><i>Karakterler</i>
Çavuş Gesler	<b>Çavuş Gesler</b><br><br><hr style="border: 7px solid green; width:20%; margin-left:0;"></hr><br><i>9. Bölük, 8. Lejyon Komandoları</i><br><i>Karakterler</i>
Borduke	<b>Çavuş Borduke</b><br><br><hr style="border: 7px solid green; width:20%; margin-left:0;"></hr><br><i>9. Bölük, 8. Lejyon Komandoları</i><br><i>Karakterler</i>
Onbaşı Katran	<b>Onbaşı Katran</b><br><i>Tarr</i><br><br><hr style="border: 7px solid green; width:20%; margin-left:0;"></hr><br><i>9. Bölük, 8. Lejyon Komandoları</i><br><i>Karakterler</i>
Katran	<b>Onbaşı Katran</b><br><i>Tarr</i><br><br><hr style="border: 7px solid green; width:20%; margin-left:0;"></hr><br><i>9. Bölük, 8. Lejyon Komandoları</i><br><i>Karakterler</i>
Onbaşı Bulutlu	<b>Onbaşı Bulutlu</b><br><i>Stormy</i><br><br><hr style="border: 7px solid green; width:20%; margin-left:0;"></hr><br><i>9. Bölük, 8. Lejyon Komandoları</i><br><i>Karakterler</i>
Bulutlu	<b>Onbaşı Bulutlu</b><br><i>Stormy</i><br><br><hr style="border: 7px solid green; width:20%; margin-left:0;"></hr><br><i>9. Bölük, 8. Lejyon Komandoları</i><br><i>Karakterler</i>
Onbaşı Hubb	<b>Onbaşı Hubb</b><br><br><hr style="border: 7px solid green; width:20%; margin-left:0;"></hr><br><i>9. Bölük, 8. Lejyon Komandoları</i><br><i>Karakterler</i>
Hubb	<b>Onbaşı Hubb</b><br><br><hr style="border: 7px solid green; width:20%; margin-left:0;"></hr><br><i>9. Bölük, 8. Lejyon Komandoları</i><br><i>Karakterler</i>
Şişe	<b>Şişe</b><br><i>Bottle</i><br>bir manga büyücüsü<br><hr style="border: 7px solid green; width:20%; margin-left:0;"></hr><br><i>9. Bölük, 8. Lejyon Komandoları</i><br><i>Karakterler</i>
Gülücük	<b>Gülücük</b><br><i>Smiles</i><br><br><hr style="border: 7px solid green; width:20%; margin-left:0;"></hr><br><i>9. Bölük, 8. Lejyon Komandoları</i><br><i>Karakterler</i>
Koryk	<b>Koryk</b><br>bir yarı—Seti asker<br><hr style="border: 7px solid green; width:20%; margin-left:0;"></hr><br><i>9. Bölük, 8. Lejyon Komandoları</i><br><i>Karakterler</i>
Ağzıbozuk	<b>Ağzıbozuk</b><br>bir lağımcı<br><hr style="border: 7px solid green; width:20%; margin-left:0;"></hr><br><i>9. Bölük, 8. Lejyon Komandoları</i><br><i>Karakterler</i>
Hakikat	<b>Hakikat</b><br><i>Truth</i><br><br><hr style="border: 7px solid green; width:20%; margin-left:0;"></hr><br><i>9. Bölük, 8. Lejyon Komandoları</i><br><i>Karakterler</i>
Pella	<b>Pella</b><br><br><hr style="border: 7px solid green; width:20%; margin-left:0;"></hr><br><i>9. Bölük, 8. Lejyon Komandoları</i><br><i>Karakterler</i>
Tavos Pond	<b>Tavos Pond</b><br><br><hr style="border: 7px solid green; width:20%; margin-left:0;"></hr><br><i>9. Bölük, 8. Lejyon Komandoları</i><br><i>Karakterler</i>
Tavos	<b>Tavos Pond</b><br><br><hr style="border: 7px solid green; width:20%; margin-left:0;"></hr><br><i>9. Bölük, 8. Lejyon Komandoları</i><br><i>Karakterler</i>
Pond	<b>Tavos Pond</b><br><br><hr style="border: 7px solid green; width:20%; margin-left:0;"></hr><br><i>9. Bölük, 8. Lejyon Komandoları</i><br><i>Karakterler</i>
Kumlar	<b>Kumlar</b><br><i>Sands</i><br><br><hr style="border: 7px solid green; width:20%; margin-left:0;"></hr><br><i>9. Bölük, 8. Lejyon Komandoları</i><br><i>Karakterler</i>
Balgrid	<b>Balgrid</b><br><br><hr style="border: 7px solid green; width:20%; margin-left:0;"></hr><br><i>9. Bölük, 8. Lejyon Komandoları</i><br><i>Karakterler</i>
Ibb	<b>Ibb</b><br><br><hr style="border: 7px solid green; width:20%; margin-left:0;"></hr><br><i>9. Bölük, 8. Lejyon Komandoları</i><br><i>Karakterler</i>
Belki	<b>Belki</b><br><i>Maybe</i><br><br><hr style="border: 7px solid green; width:20%; margin-left:0;"></hr><br><i>9. Bölük, 8. Lejyon Komandoları</i><br><i>Karakterler</i>
Kopuzcu	<b>Kopuzcu</b><br><i>Lutes</i><br><br><hr style="border: 7px solid green; width:20%; margin-left:0;"></hr><br><i>9. Bölük, 8. Lejyon Komandoları</i><br><i>Karakterler</i>
Çavuş Mosel	<b>Çavuş Mosel</b><br><br><hr style="border: 7px solid green; width:20%; margin-left:0;"></hr><br><i>9. Bölük, 8. Lejyon'dan Seçkin Ağır Piyadeler</i><br><i>Karakterler</i>
Mosel	<b>Çavuş Mosel</b><br><br><hr style="border: 7px solid green; width:20%; margin-left:0;"></hr><br><i>9. Bölük, 8. Lejyon'dan Seçkin Ağır Piyadeler</i><br><i>Karakterler</i>
Çavuş Sobelone	<b>Çavuş Sobelone</b><br><br><hr style="border: 7px solid green; width:20%; margin-left:0;"></hr><br><i>9. Bölük, 8. Lejyon'dan Seçkin Ağır Piyadeler</i><br><i>Karakterler</i>
Sobelone	<b>Çavuş Sobelone</b><br><br><hr style="border: 7px solid green; width:20%; margin-left:0;"></hr><br><i>9. Bölük, 8. Lejyon'dan Seçkin Ağır Piyadeler</i><br><i>Karakterler</i>
Çavuş Tugg	<b>Çavuş Tugg</b><br><br><hr style="border: 7px solid green; width:20%; margin-left:0;"></hr><br><i>9. Bölük, 8. Lejyon'dan Seçkin Ağır Piyadeler</i><br><i>Karakterler</i>
Tugg	<b>Çavuş Tugg</b><br><br><hr style="border: 7px solid green; width:20%; margin-left:0;"></hr><br><i>9. Bölük, 8. Lejyon'dan Seçkin Ağır Piyadeler</i><br><i>Karakterler</i>
Parlakzekâ	<b>Parlakzekâ</b><br><i>Flashwit</i><br><br><hr style="border: 7px solid green; width:20%; margin-left:0;"></hr><br><i>9. Bölük, 8. Lejyon'dan Seçkin Ağır Piyadeler</i><br><i>Karakterler</i>
Uru Hela	<b>Uru Hela</b><br><br><hr style="border: 7px solid green; width:20%; margin-left:0;"></hr><br><i>9. Bölük, 8. Lejyon'dan Seçkin Ağır Piyadeler</i><br><i>Karakterler</i>
Uru	<b>Uru Hela</b><br><br><hr style="border: 7px solid green; width:20%; margin-left:0;"></hr><br><i>9. Bölük, 8. Lejyon'dan Seçkin Ağır Piyadeler</i><br><i>Karakterler</i>
Hela	<b>Uru Hela</b><br><br><hr style="border: 7px solid green; width:20%; margin-left:0;"></hr><br><i>9. Bölük, 8. Lejyon'dan Seçkin Ağır Piyadeler</i><br><i>Karakterler</i>
Çanak	<b>Çanak</b><br><i>Bowl</i><br><br><hr style="border: 7px solid green; width:20%; margin-left:0;"></hr><br><i>9. Bölük, 8. Lejyon'dan Seçkin Ağır Piyadeler</i><br><i>Karakterler</i>
Kısaburun	<b>Kısaburun</b><br><i>Shortnose</i><br><br><hr style="border: 7px solid green; width:20%; margin-left:0;"></hr><br><i>9. Bölük, 8. Lejyon'dan Seçkin Ağır Piyadeler</i><br><i>Karakterler</i>
Çavuş Merhem	<b>Çavuş Merhem</b><br><i>Balm</i><br><br><hr style="border: 7px solid green; width:20%; margin-left:0;"></hr><br><i>9. Bölük, 8. Lejyon'dan Seçkin Orta Piyadeler</i><br><i>Karakterler</i>
Merhem	<b>Çavuş Merhem</b><br><i>Balm</i><br><br><hr style="border: 7px solid green; width:20%; margin-left:0;"></hr><br><i>9. Bölük, 8. Lejyon'dan Seçkin Orta Piyadeler</i><br><i>Karakterler</i>
Çavuş Moak	<b>Çavuş Moak</b><br><br><hr style="border: 7px solid green; width:20%; margin-left:0;"></hr><br><i>9. Bölük, 8. Lejyon'dan Seçkin Orta Piyadeler</i><br><i>Karakterler</i>
Moak	<b>Çavuş Moak</b><br><br><hr style="border: 7px solid green; width:20%; margin-left:0;"></hr><br><i>9. Bölük, 8. Lejyon'dan Seçkin Orta Piyadeler</i><br><i>Karakterler</i>
Çavuş Thom Tissy	<b>Çavuş Thom Tissy</b><br><br><hr style="border: 7px solid green; width:20%; margin-left:0;"></hr><br><i>9. Bölük, 8. Lejyon'dan Seçkin Orta Piyadeler</i><br><i>Karakterler</i>
Thom	<b>Çavuş Thom Tissy</b><br><br><hr style="border: 7px solid green; width:20%; margin-left:0;"></hr><br><i>9. Bölük, 8. Lejyon'dan Seçkin Orta Piyadeler</i><br><i>Karakterler</i>
Tissy	<b>Çavuş Thom Tissy</b><br><br><hr style="border: 7px solid green; width:20%; margin-left:0;"></hr><br><i>9. Bölük, 8. Lejyon'dan Seçkin Orta Piyadeler</i><br><i>Karakterler</i>
Onbaşı Ölükoku	<b>Onbaşı Ölükoku</b><br><i>Deadsmell</i><br><br><hr style="border: 7px solid green; width:20%; margin-left:0;"></hr><br><i>9. Bölük, 8. Lejyon'dan Seçkin Orta Piyadeler</i><br><i>Karakterler</i>
Ölükoku	<b>Onbaşı Ölükoku</b><br><i>Deadsmell</i><br><br><hr style="border: 7px solid green; width:20%; margin-left:0;"></hr><br><i>9. Bölük, 8. Lejyon'dan Seçkin Orta Piyadeler</i><br><i>Karakterler</i>
Onbaşı Yanık	<b>Onbaşı Yanık</b><br><i>Burnt</i><br><br><hr style="border: 7px solid green; width:20%; margin-left:0;"></hr><br><i>9. Bölük, 8. Lejyon'dan Seçkin Orta Piyadeler</i><br><i>Karakterler</i>
Yanık	<b>Onbaşı Yanık</b><br><i>Burnt</i><br><br><hr style="border: 7px solid green; width:20%; margin-left:0;"></hr><br><i>9. Bölük, 8. Lejyon'dan Seçkin Orta Piyadeler</i><br><i>Karakterler</i>
Onbaşı Lale	<b>Onbaşı Lale</b><br><i>Tulip</i><br><br><hr style="border: 7px solid green; width:20%; margin-left:0;"></hr><br><i>9. Bölük, 8. Lejyon'dan Seçkin Orta Piyadeler</i><br><i>Karakterler</i>
Lale	<b>Onbaşı Lale</b><br><i>Tulip</i><br><br><hr style="border: 7px solid green; width:20%; margin-left:0;"></hr><br><i>9. Bölük, 8. Lejyon'dan Seçkin Orta Piyadeler</i><br><i>Karakterler</i>
Gırtlakkesen	<b>Gırtlakkesen</b><br><i>Throatslitter</i><br><br><hr style="border: 7px solid green; width:20%; margin-left:0;"></hr><br><i>9. Bölük, 8. Lejyon'dan Seçkin Orta Piyadeler</i><br><i>Karakterler</i>
Güneşekarşı	<b>Güneşekarşı</b><br><i>Widdershins</i><br><br><hr style="border: 7px solid green; width:20%; margin-left:0;"></hr><br><i>9. Bölük, 8. Lejyon'dan Seçkin Orta Piyadeler</i><br><i>Karakterler</i>
Galt	<b>Galt</b><br><br><hr style="border: 7px solid green; width:20%; margin-left:0;"></hr><br><i>9. Bölük, 8. Lejyon'dan Seçkin Orta Piyadeler</i><br><i>Karakterler</i>
Lobe	<b>Lobe</b><br><br><hr style="border: 7px solid green; width:20%; margin-left:0;"></hr><br><i>9. Bölük, 8. Lejyon'dan Seçkin Orta Piyadeler</i><br><i>Karakterler</i>
İstifçi	<b>İstifçi</b><br><i>Stacker</i><br><br><hr style="border: 7px solid green; width:20%; margin-left:0;"></hr><br><i>9. Bölük, 8. Lejyon'dan Seçkin Orta Piyadeler</i><br><i>Karakterler</i>
Rampa	<b>Rampa</b><br><i>Ramp</i><br><br><hr style="border: 7px solid green; width:20%; margin-left:0;"></hr><br><i>9. Bölük, 8. Lejyon'dan Seçkin Orta Piyadeler</i><br><i>Karakterler</i>
Kadir	<b>Kadir</b><br><i>Able</i><br><br><hr style="border: 7px solid green; width:20%; margin-left:0;"></hr><br><i>9. Bölük, 8. Lejyon'dan Seçkin Orta Piyadeler</i><br><i>Karakterler</i>
Çavuş Cord	<b>Çavuş Cord</b><br>2. Bölük, Ashok Alayı<br><hr style="border: 7px solid green; width:20%; margin-left:0;"></hr><br><i>Malazan İmparatorluğu'nun Diğer Askerleri</i><br><i>Karakterler</i>
Cord	<b>Çavuş Cord</b><br>2. Bölük, Ashok Alayı<br><hr style="border: 7px solid green; width:20%; margin-left:0;"></hr><br><i>Malazan İmparatorluğu'nun Diğer Askerleri</i><br><i>Karakterler</i>
Ebron	<b>Ebron</b><br>5. manga, büyücü<br><hr style="border: 7px solid green; width:20%; margin-left:0;"></hr><br><i>Malazan İmparatorluğu'nun Diğer Askerleri</i><br><i>Karakterler</i>
Topal	<b>Topal</b><br><i>Limp</i><br>5. manga<br><hr style="border: 7px solid green; width:20%; margin-left:0;"></hr><br><i>Malazan İmparatorluğu'nun Diğer Askerleri</i><br><i>Karakterler</i>
Çan	<b>Çan</b><br><i>Bell</i><br>5. manga<br><hr style="border: 7px solid green; width:20%; margin-left:0;"></hr><br><i>Malazan İmparatorluğu'nun Diğer Askerleri</i><br><i>Karakterler</i>
Onbaşı Kırık	<b>Onbaşı Kırık</b><br><i>Shard</i><br>5. Manga<br><hr style="border: 7px solid green; width:20%; margin-left:0;"></hr><br><i>Malazan İmparatorluğu'nun Diğer Askerleri</i><br><i>Karakterler</i>
Kırık	<b>Onbaşı Kırık</b><br><i>Shard</i><br>5. Manga<br><hr style="border: 7px solid green; width:20%; margin-left:0;"></hr><br><i>Malazan İmparatorluğu'nun Diğer Askerleri</i><br><i>Karakterler</i>
Yüzbaşı Sevecen	<b>Yüzbaşı Sevecen</b><br><i>Kindly</i><br>2. Bölük<br><hr style="border: 7px solid green; width:20%; margin-left:0;"></hr><br><i>Malazan İmparatorluğu'nun Diğer Askerleri</i><br><i>Karakterler</i>
Sevecen	<b>Yüzbaşı Sevecen</b><br><i>Kindly</i><br>2. Bölük<br><hr style="border: 7px solid green; width:20%; margin-left:0;"></hr><br><i>Malazan İmparatorluğu'nun Diğer Askerleri</i><br><i>Karakterler</i>
Teğmen Pores	<b>Teğmen Pores</b><br>2. Bölük<br><hr style="border: 7px solid green; width:20%; margin-left:0;"></hr><br><i>Malazan İmparatorluğu'nun Diğer Askerleri</i><br><i>Karakterler</i>
Pores	<b>Teğmen Pores</b><br>2. Bölük<br><hr style="border: 7px solid green; width:20%; margin-left:0;"></hr><br><i>Malazan İmparatorluğu'nun Diğer Askerleri</i><br><i>Karakterler</i>
Jibb	<b>Jibb</b><br>Ehrlitan İnzibatı<br><hr style="border: 7px solid green; width:20%; margin-left:0;"></hr><br><i>Malazan İmparatorluğu'nun Diğer Askerleri</i><br><i>Karakterler</i>
Gullstream	<b>Gullstream</b><br>Ehrlitan İnzibatı<br><hr style="border: 7px solid green; width:20%; margin-left:0;"></hr><br><i>Malazan İmparatorluğu'nun Diğer Askerleri</i><br><i>Karakterler</i>
Scrawl	<b>Scrawl</b><br>Ehrlitan İnzibatı<br><hr style="border: 7px solid green; width:20%; margin-left:0;"></hr><br><i>Malazan İmparatorluğu'nun Diğer Askerleri</i><br><i>Karakterler</i>
Başçavuş Mert Diş	<b>Başçavuş Mert Diş</b><br><i>Braven Tooth</i><br>Malaz Kent Garnizonu<br><hr style="border: 7px solid green; width:20%; margin-left:0;"></hr><br><i>Malazan İmparatorluğu'nun Diğer Askerleri</i><br><i>Karakterler</i>
Mert	<b>Başçavuş Mert Diş</b><br><i>Braven Tooth</i><br>Malaz Kent Garnizonu<br><hr style="border: 7px solid green; width:20%; margin-left:0;"></hr><br><i>Malazan İmparatorluğu'nun Diğer Askerleri</i><br><i>Karakterler</i>
Diş	<b>Başçavuş Mert Diş</b><br><i>Braven Tooth</i><br>Malaz Kent Garnizonu<br><hr style="border: 7px solid green; width:20%; margin-left:0;"></hr><br><i>Malazan İmparatorluğu'nun Diğer Askerleri</i><br><i>Karakterler</i>
Yüzbaşı Irriz	<b>Yüzbaşı Irriz</b><br>asi<br><hr style="border: 7px solid green; width:20%; margin-left:0;"></hr><br><i>Malazan İmparatorluğu'nun Diğer Askerleri</i><br><i>Karakterler</i>
Irriz	<b>Yüzbaşı Irriz</b><br>asi<br><hr style="border: 7px solid green; width:20%; margin-left:0;"></hr><br><i>Malazan İmparatorluğu'nun Diğer Askerleri</i><br><i>Karakterler</i>
Sinn	<b>Sinn</b><br>mülteci<br><hr style="border: 7px solid green; width:20%; margin-left:0;"></hr><br><i>Malazan İmparatorluğu'nun Diğer Askerleri</i><br><i>Karakterler</i>
Gentur	<b>Gentur</b><br><br><hr style="border: 7px solid green; width:20%; margin-left:0;"></hr><br><i>Malazan İmparatorluğu'nun Diğer Askerleri</i><br><i>Karakterler</i>
Çamuratan	<b>Çamuratan</b><br><i>Mudslinger</i><br><br><hr style="border: 7px solid green; width:20%; margin-left:0;"></hr><br><i>Malazan İmparatorluğu'nun Diğer Askerleri</i><br><i>Karakterler</i>
Hawl	<b>Hawl</b><br><br><hr style="border: 7px solid green; width:20%; margin-left:0;"></hr><br><i>Malazan İmparatorluğu'nun Diğer Askerleri</i><br><i>Karakterler</i>
Kölecibaşı Silgar	<b>Kölecibaşı Silgar</b><br><br><hr style="border: 7px solid green; width:20%; margin-left:0;"></hr><br><i>Nathiiler</i><br><i>Karakterler</i>
Silgar	<b>Kölecibaşı Silgar</b><br><br><hr style="border: 7px solid green; width:20%; margin-left:0;"></hr><br><i>Nathiiler</i><br><i>Karakterler</i>
Damisk	<b>Damisk</b><br><br><hr style="border: 7px solid green; width:20%; margin-left:0;"></hr><br><i>Nathiiler</i><br><i>Karakterler</i>
Balantis	<b>Balantis</b><br><br><hr style="border: 7px solid green; width:20%; margin-left:0;"></hr><br><i>Nathiiler</i><br><i>Karakterler</i>
Astabb	<b>Astabb</b><br><br><hr style="border: 7px solid green; width:20%; margin-left:0;"></hr><br><i>Nathiiler</i><br><i>Karakterler</i>
Borrug	<b>Borrug</b><br><br><hr style="border: 7px solid green; width:20%; margin-left:0;"></hr><br><i>Nathiiler</i><br><i>Karakterler</i>
Torvald Nom	<b>Torvald Nom</b><br><br><hr style="border: 7px solid green; width:20%; margin-left:0;"></hr><br><i>Genabackis'teki Diğerleri</i><br><i>Karakterler</i>
Torvald	<b>Torvald Nom</b><br><br><hr style="border: 7px solid green; width:20%; margin-left:0;"></hr><br><i>Genabackis'teki Diğerleri</i><br><i>Karakterler</i>
Nom	<b>Torvald Nom</b><br><br><hr style="border: 7px solid green; width:20%; margin-left:0;"></hr><br><i>Genabackis'teki Diğerleri</i><br><i>Karakterler</i>
Calm	<b>Calm</b><br><br><hr style="border: 7px solid green; width:20%; margin-left:0;"></hr><br><i>Genabackis'teki Diğerleri</i><br><i>Karakterler</i>
Ganal	<b>Ganal</b><br><br><hr style="border: 7px solid green; width:20%; margin-left:0;"></hr><br><i>Ötekiler</i><br><i>Karakterler</i>
Sha'ik	<b>Sha'ik</b><br><i>önceden Paran Hanesi'nden Felisin</i><br>Hortum Tanrıça'nın Seçilmişi (önceden Paran Hanesi'nden Felisin)<br><hr style="border: 7px solid green; width:20%; margin-left:0;"></hr><br><i>Sha'ik'in Kıyamet Ordusu</i><br><i>Karakterler</i>
Genç Felisin	<b>Genç Felisin</b><br>onun evlatlık kızı<br><hr style="border: 7px solid green; width:20%; margin-left:0;"></hr><br><i>Sha'ik'in Kıyamet Ordusu</i><br><i>Karakterler</i>
Felisin	<b>Genç Felisin</b><br>onun evlatlık kızı<br><hr style="border: 7px solid green; width:20%; margin-left:0;"></hr><br><i>Sha'ik'in Kıyamet Ordusu</i><br><i>Karakterler</i>
Toblakai	<b>Toblakai</b><br><br><hr style="border: 7px solid green; width:20%; margin-left:0;"></hr><br><i>Sha'ik'in Kıyamet Ordusu</i><br><i>Karakterler</i>
Gürzlü Leoman	<b>Gürzlü Leoman</b><br><br><hr style="border: 7px solid green; width:20%; margin-left:0;"></hr><br><i>Sha'ik'in Kıyamet Ordusu</i><br><i>Karakterler</i>
Leoman	<b>Gürzlü Leoman</b><br><br><hr style="border: 7px solid green; width:20%; margin-left:0;"></hr><br><i>Sha'ik'in Kıyamet Ordusu</i><br><i>Karakterler</i>
Baş Büyücü L'oric	<b>Baş Büyücü L'oric</b><br><br><hr style="border: 7px solid green; width:20%; margin-left:0;"></hr><br><i>Sha'ik'in Kıyamet Ordusu</i><br><i>Karakterler</i>
L'oric	<b>Baş Büyücü L'oric</b><br><br><hr style="border: 7px solid green; width:20%; margin-left:0;"></hr><br><i>Sha'ik'in Kıyamet Ordusu</i><br><i>Karakterler</i>
Baş Büyücü Bidithal	<b>Baş Büyücü Bidithal</b><br><br><hr style="border: 7px solid green; width:20%; margin-left:0;"></hr><br><i>Sha'ik'in Kıyamet Ordusu</i><br><i>Karakterler</i>
Bidithal	<b>Baş Büyücü Bidithal</b><br><br><hr style="border: 7px solid green; width:20%; margin-left:0;"></hr><br><i>Sha'ik'in Kıyamet Ordusu</i><br><i>Karakterler</i>
Baş Büyücü Febryl	<b>Baş Büyücü Febryl</b><br><br><hr style="border: 7px solid green; width:20%; margin-left:0;"></hr><br><i>Sha'ik'in Kıyamet Ordusu</i><br><i>Karakterler</i>
Febryl	<b>Baş Büyücü Febryl</b><br><br><hr style="border: 7px solid green; width:20%; margin-left:0;"></hr><br><i>Sha'ik'in Kıyamet Ordusu</i><br><i>Karakterler</i>
Heboric Hayalet Eller	<b>Heboric Hayalet Eller</b><br><br><hr style="border: 7px solid green; width:20%; margin-left:0;"></hr><br><i>Sha'ik'in Kıyamet Ordusu</i><br><i>Karakterler</i>
Heboric	<b>Heboric Hayalet Eller</b><br><br><hr style="border: 7px solid green; width:20%; margin-left:0;"></hr><br><i>Sha'ik'in Kıyamet Ordusu</i><br><i>Karakterler</i>
Kamist Reloe	<b>Kamist Reloe</b><br>Korbolo Dom'un büyücüsü<br><hr style="border: 7px solid green; width:20%; margin-left:0;"></hr><br><i>Sha'ik'in Kıyamet Ordusu</i><br><i>Karakterler</i>
Kamist	<b>Kamist Reloe</b><br>Korbolo Dom'un büyücüsü<br><hr style="border: 7px solid green; width:20%; margin-left:0;"></hr><br><i>Sha'ik'in Kıyamet Ordusu</i><br><i>Karakterler</i>
Reloe	<b>Kamist Reloe</b><br>Korbolo Dom'un büyücüsü<br><hr style="border: 7px solid green; width:20%; margin-left:0;"></hr><br><i>Sha'ik'in Kıyamet Ordusu</i><br><i>Karakterler</i>
Henaras	<b>Henaras</b><br>bir efsuncu<br><hr style="border: 7px solid green; width:20%; margin-left:0;"></hr><br><i>Sha'ik'in Kıyamet Ordusu</i><br><i>Karakterler</i>
Fayelle	<b>Fayelle</b><br>bir efsuncu<br><hr style="border: 7px solid green; width:20%; margin-left:0;"></hr><br><i>Sha'ik'in Kıyamet Ordusu</i><br><i>Karakterler</i>
Mathok	<b>Mathok</b><br>Çöl Kabileleri Savaş Lideri<br><hr style="border: 7px solid green; width:20%; margin-left:0;"></hr><br><i>Sha'ik'in Kıyamet Ordusu</i><br><i>Karakterler</i>
T'morol	<b>T'morol</b><br>onun koruması<br><hr style="border: 7px solid green; width:20%; margin-left:0;"></hr><br><i>Sha'ik'in Kıyamet Ordusu</i><br><i>Karakterler</i>
Corabb Bhilan Thenu'alas	<b>Corabb Bhilan Thenu'alas</b><br>Leoman'ın bölüğünde bir subay<br><hr style="border: 7px solid green; width:20%; margin-left:0;"></hr><br><i>Sha'ik'in Kıyamet Ordusu</i><br><i>Karakterler</i>
Corabb	<b>Corabb Bhilan Thenu'alas</b><br>Leoman'ın bölüğünde bir subay<br><hr style="border: 7px solid green; width:20%; margin-left:0;"></hr><br><i>Sha'ik'in Kıyamet Ordusu</i><br><i>Karakterler</i>
Bhilan	<b>Corabb Bhilan Thenu'alas</b><br>Leoman'ın bölüğünde bir subay<br><hr style="border: 7px solid green; width:20%; margin-left:0;"></hr><br><i>Sha'ik'in Kıyamet Ordusu</i><br><i>Karakterler</i>
Scillara	<b>Scillara</b><br>bir kamp sivili<br><hr style="border: 7px solid green; width:20%; margin-left:0;"></hr><br><i>Sha'ik'in Kıyamet Ordusu</i><br><i>Karakterler</i>
Duryl	<b>Duryl</b><br>bir ulak<br><hr style="border: 7px solid green; width:20%; margin-left:0;"></hr><br><i>Sha'ik'in Kıyamet Ordusu</i><br><i>Karakterler</i>
Ethume	<b>Ethume</b><br>bir onbaşı<br><hr style="border: 7px solid green; width:20%; margin-left:0;"></hr><br><i>Sha'ik'in Kıyamet Ordusu</i><br><i>Karakterler</i>
Korbolo Dom	<b>Korbolo Dom</b><br>asi bir Napanlı<br><hr style="border: 7px solid green; width:20%; margin-left:0;"></hr><br><i>Sha'ik'in Kıyamet Ordusu</i><br><i>Karakterler</i>
Korbolo	<b>Korbolo Dom</b><br>asi bir Napanlı<br><hr style="border: 7px solid green; width:20%; margin-left:0;"></hr><br><i>Sha'ik'in Kıyamet Ordusu</i><br><i>Karakterler</i>
Dom	<b>Korbolo Dom</b><br>asi bir Napanlı<br><hr style="border: 7px solid green; width:20%; margin-left:0;"></hr><br><i>Sha'ik'in Kıyamet Ordusu</i><br><i>Karakterler</i>
Kasanal	<b>Kasanal</b><br>onun kiralık katili<br><hr style="border: 7px solid green; width:20%; margin-left:0;"></hr><br><i>Sha'ik'in Kıyamet Ordusu</i><br><i>Karakterler</i>
Kalam Mekhar	<b>Kalam Mekhar</b><br>bir suikastçı<br><hr style="border: 7px solid green; width:20%; margin-left:0;"></hr><br><i>Ötekiler</i><br><i>Karakterler</i>
Kalam	<b>Kalam Mekhar</b><br>bir suikastçı<br><hr style="border: 7px solid green; width:20%; margin-left:0;"></hr><br><i>Ötekiler</i><br><i>Karakterler</i>
Mekhar	<b>Kalam Mekhar</b><br>bir suikastçı<br><hr style="border: 7px solid green; width:20%; margin-left:0;"></hr><br><i>Ötekiler</i><br><i>Karakterler</i>
Trull Sengar	<b>Trull Sengar</b><br>bir Tiste Edur<br><hr style="border: 7px solid green; width:20%; margin-left:0;"></hr><br><i>Ötekiler</i><br><i>Karakterler</i>
Trull	<b>Trull Sengar</b><br>bir Tiste Edur<br><hr style="border: 7px solid green; width:20%; margin-left:0;"></hr><br><i>Ötekiler</i><br><i>Karakterler</i>
Sengar	<b>Trull Sengar</b><br>bir Tiste Edur<br><hr style="border: 7px solid green; width:20%; margin-left:0;"></hr><br><i>Ötekiler</i><br><i>Karakterler</i>
Onrack	<b>Onrack</b><br>bir T'lan Imass<br><hr style="border: 7px solid green; width:20%; margin-left:0;"></hr><br><i>Ötekiler</i><br><i>Karakterler</i>
Kesici	<b>Kesici</b><br><i>Cutter</i><br>bir suikastçı (Crokus adıyla da bilinir)<br><hr style="border: 7px solid green; width:20%; margin-left:0;"></hr><br><i>Ötekiler</i><br><i>Karakterler</i>
Rellock	<b>Rellock</b><br>Apsalar'ın babası<br><hr style="border: 7px solid green; width:20%; margin-left:0;"></hr><br><i>Ötekiler</i><br><i>Karakterler</i>
Kotilyon	<b>Kotilyon</b><br><i>Cotillion</i><br>Urgan, Suikastçılar Hamisi, Gölge Üst Hanesi Köprüyakanlar<br><hr style="border: 7px solid green; width:20%; margin-left:0;"></hr><br><i>Ötekiler</i><br><i>Karakterler</i>
Rood	<b>Rood</b><br>bir Gölge Tazısı<br><hr style="border: 7px solid green; width:20%; margin-left:0;"></hr><br><i>Ötekiler</i><br><i>Karakterler</i>
Kör	<b>Kör</b><br><i>Blind</i><br>bir Gölge Tazısı<br><hr style="border: 7px solid green; width:20%; margin-left:0;"></hr><br><i>Ötekiler</i><br><i>Karakterler</i>
Darist	<b>Darist</b><br>bir Tiste Andii<br><hr style="border: 7px solid green; width:20%; margin-left:0;"></hr><br><i>Ötekiler</i><br><i>Karakterler</i>
Ba'ienrok	<b>Ba'ienrok</b><br><i>Bekçi</i><br>bir münzevi<br><hr style="border: 7px solid green; width:20%; margin-left:0;"></hr><br><i>Ötekiler</i><br><i>Karakterler</i>
Ibra Gholan	<b>Ibra Gholan</b><br>bir T'lan Imass Klan Lideri<br><hr style="border: 7px solid green; width:20%; margin-left:0;"></hr><br><i>Ötekiler</i><br><i>Karakterler</i>
Ibra	<b>Ibra Gholan</b><br>bir T'lan Imass Klan Lideri<br><hr style="border: 7px solid green; width:20%; margin-left:0;"></hr><br><i>Ötekiler</i><br><i>Karakterler</i>
Gholan	<b>Ibra Gholan</b><br>bir T'lan Imass Klan Lideri<br><hr style="border: 7px solid green; width:20%; margin-left:0;"></hr><br><i>Ötekiler</i><br><i>Karakterler</i>
Monok Ochem	<b>Monok Ochem</b><br>Logros T'lan Imasslardan bir Kemikbakar<br><hr style="border: 7px solid green; width:20%; margin-left:0;"></hr><br><i>Ötekiler</i><br><i>Karakterler</i>
Monok	<b>Monok Ochem</b><br>Logros T'lan Imasslardan bir Kemikbakar<br><hr style="border: 7px solid green; width:20%; margin-left:0;"></hr><br><i>Ötekiler</i><br><i>Karakterler</i>
Ochem	<b>Monok Ochem</b><br>Logros T'lan Imasslardan bir Kemikbakar<br><hr style="border: 7px solid green; width:20%; margin-left:0;"></hr><br><i>Ötekiler</i><br><i>Karakterler</i>
Haran Epal	<b>Haran Epal</b><br>bir T'lan Imass<br><hr style="border: 7px solid green; width:20%; margin-left:0;"></hr><br><i>Ötekiler</i><br><i>Karakterler</i>
Haran	<b>Haran Epal</b><br>bir T'lan Imass<br><hr style="border: 7px solid green; width:20%; margin-left:0;"></hr><br><i>Ötekiler</i><br><i>Karakterler</i>
Epal	<b>Haran Epal</b><br>bir T'lan Imass<br><hr style="border: 7px solid green; width:20%; margin-left:0;"></hr><br><i>Ötekiler</i><br><i>Karakterler</i>
Olar Shayn	<b>Olar Shayn</b><br>bir T'lan Imass<br><hr style="border: 7px solid green; width:20%; margin-left:0;"></hr><br><i>Ötekiler</i><br><i>Karakterler</i>
Olar	<b>Olar Shayn</b><br>bir T'lan Imass<br><hr style="border: 7px solid green; width:20%; margin-left:0;"></hr><br><i>Ötekiler</i><br><i>Karakterler</i>
Shayn	<b>Olar Shayn</b><br>bir T'lan Imass<br><hr style="border: 7px solid green; width:20%; margin-left:0;"></hr><br><i>Ötekiler</i><br><i>Karakterler</i>
Grikurbağa	<b>Grikurbağa</b><br><i>Greyfrog</i><br>bir iblis familyar<br><hr style="border: 7px solid green; width:20%; margin-left:0;"></hr><br><i>Ötekiler</i><br><i>Karakterler</i>
Apt	<b>Apt</b><br><i>Aptorian</i><br>bir Gölge anaç iblisi (Aptorian)<br><hr style="border: 7px solid green; width:20%; margin-left:0;"></hr><br><i>Ötekiler</i><br><i>Karakterler</i>
Azalan	<b>Azalan</b><br>bir Gölge iblisi<br><hr style="border: 7px solid green; width:20%; margin-left:0;"></hr><br><i>Ötekiler</i><br><i>Karakterler</i>
Panek	<b>Panek</b><br>bir Gölge çocuğu<br><hr style="border: 7px solid green; width:20%; margin-left:0;"></hr><br><i>Ötekiler</i><br><i>Karakterler</i>
Mebra	<b>Mebra</b><br>Erhlitan'daki bir casus<br><hr style="border: 7px solid green; width:20%; margin-left:0;"></hr><br><i>Ötekiler</i><br><i>Karakterler</i>
Iskaral Pust	<b>Iskaral Pust</b><br>bir Gölge rahibi<br><hr style="border: 7px solid green; width:20%; margin-left:0;"></hr><br><i>Ötekiler</i><br><i>Karakterler</i>
Iskaral	<b>Iskaral Pust</b><br>bir Gölge rahibi<br><hr style="border: 7px solid green; width:20%; margin-left:0;"></hr><br><i>Ötekiler</i><br><i>Karakterler</i>
Pust	<b>Iskaral Pust</b><br>bir Gölge rahibi<br><hr style="border: 7px solid green; width:20%; margin-left:0;"></hr><br><i>Ötekiler</i><br><i>Karakterler</i>
Mogora	<b>Mogora</b><br>onun D'iver karısı<br><hr style="border: 7px solid green; width:20%; margin-left:0;"></hr><br><i>Ötekiler</i><br><i>Karakterler</i>
Cynnigig	<b>Cynnigig</b><br>bir Jaghut<br><hr style="border: 7px solid green; width:20%; margin-left:0;"></hr><br><i>Ötekiler</i><br><i>Karakterler</i>
Phyrlis	<b>Phyrlis</b><br>bir Jaghut<br><hr style="border: 7px solid green; width:20%; margin-left:0;"></hr><br><i>Ötekiler</i><br><i>Karakterler</i>
Aramala	<b>Aramala</b><br>bir Jaghut<br><hr style="border: 7px solid green; width:20%; margin-left:0;"></hr><br><i>Ötekiler</i><br><i>Karakterler</i>
Icarium	<b>Icarium</b><br>bir Jhag<br><hr style="border: 7px solid green; width:20%; margin-left:0;"></hr><br><i>Ötekiler</i><br><i>Karakterler</i>
Mappo Runt	<b>Mappo Runt</b><br>bir Trell<br><hr style="border: 7px solid green; width:20%; margin-left:0;"></hr><br><i>Ötekiler</i><br><i>Karakterler</i>
Mappo	<b>Mappo Runt</b><br>bir Trell<br><hr style="border: 7px solid green; width:20%; margin-left:0;"></hr><br><i>Ötekiler</i><br><i>Karakterler</i>
Runt	<b>Mappo Runt</b><br>bir Trell<br><hr style="border: 7px solid green; width:20%; margin-left:0;"></hr><br><i>Ötekiler</i><br><i>Karakterler</i>
Jorrude	<b>Jorrude</b><br>bir Tiste Liosan Seneşal<br><hr style="border: 7px solid green; width:20%; margin-left:0;"></hr><br><i>Ötekiler</i><br><i>Karakterler</i>
Malachar	<b>Malachar</b><br>bir Tiste Liosan<br><hr style="border: 7px solid green; width:20%; margin-left:0;"></hr><br><i>Ötekiler</i><br><i>Karakterler</i>
Enias	<b>Enias</b><br>bir Tiste Liosan<br><hr style="border: 7px solid green; width:20%; margin-left:0;"></hr><br><i>Ötekiler</i><br><i>Karakterler</i>
Orenas	<b>Orenas</b><br>bir Tiste Liosan<br><hr style="border: 7px solid green; width:20%; margin-left:0;"></hr><br><i>Ötekiler</i><br><i>Karakterler</i>
Anomander Rake	<b>Anomander Rake</b><br>Karanlığın Oğlu<br><hr style="border: 7px solid green; width:20%; margin-left:0;"></hr><br><i>Ermişler</i><br><i>Sözlük</i>
Anomander	<b>Anomander Rake</b><br>Karanlığın Oğlu<br><hr style="border: 7px solid green; width:20%; margin-left:0;"></hr><br><i>Ermişler</i><br><i>Sözlük</i>
Rake	<b>Anomander Rake</b><br>Karanlığın Oğlu<br><hr style="border: 7px solid green; width:20%; margin-left:0;"></hr><br><i>Ermişler</i><br><i>Sözlük</i>
Apsalar	<b>Apsalar</b><br>Hırsızlar Leydisi<br>bir suikastçı<br><hr style="border: 7px solid green; width:20%; margin-left:0;"></hr><br><i>Ermişler</i><br><i>Sözlük</i>
Azathlar	<b>Azathlar</b><br>Haneler<br><hr style="border: 7px solid green; width:20%; margin-left:0;"></hr><br><i>Ermişler</i><br><i>Sözlük</i>
Beru	<b>Beru</b><br>Fırtınalar Lordu<br><hr style="border: 7px solid green; width:20%; margin-left:0;"></hr><br><i>Ermişler</i><br><i>Sözlük</i>
Burn	<b>Burn</b><br>Uyuyan Tanrıça<br><hr style="border: 7px solid green; width:20%; margin-left:0;"></hr><br><i>Ermişler</i><br><i>Sözlük</i>
D'rek	<b>D'rek</b><br>Güz Solucanı<br><hr style="border: 7px solid green; width:20%; margin-left:0;"></hr><br><i>Ermişler</i><br><i>Sözlük</i>
Deragothlar	<b>Deragothlar</b><br>Dessimbelackis İlk İmparatorluğu'ndan<br><hr style="border: 7px solid green; width:20%; margin-left:0;"></hr><br><i>Ermişler</i><br><i>Sözlük</i>
Dessembrae	<b>Dessembrae</b><br>Gözyaşları Lordu<br><hr style="border: 7px solid green; width:20%; margin-left:0;"></hr><br><i>Ermişler</i><br><i>Sözlük</i>
Draconus	<b>Draconus</b><br>bir Ata Tanrı ve Dragnipur kılıcının üreticisi<br><hr style="border: 7px solid green; width:20%; margin-left:0;"></hr><br><i>Ermişler</i><br><i>Sözlük</i>
Düşler Kraliçesi	<b>Düşler Kraliçesi</b><br>Yaşam Üst Hanesi Kraliçesi<br><hr style="border: 7px solid green; width:20%; margin-left:0;"></hr><br><i>Ermişler</i><br><i>Sözlük</i>
Fener	<b>Fener</b><br>Mahrum<br><hr style="border: 7px solid green; width:20%; margin-left:0;"></hr><br><i>Ermişler</i><br><i>Sözlük</i>
Gedderone	<b>Gedderone</b><br>Bahar ve Yeniden Doğuş Leydisi<br><hr style="border: 7px solid green; width:20%; margin-left:0;"></hr><br><i>Ermişler</i><br><i>Sözlük</i>
Gölgetaht	<b>Gölgetaht</b><br>Ammanas, Gölge Üst Hanesi Kralı<br><hr style="border: 7px solid green; width:20%; margin-left:0;"></hr><br><i>Ermişler</i><br><i>Sözlük</i>
Hood	<b>Hood</b><br>Ölüm Üst Hanesi Kralı<br><hr style="border: 7px solid green; width:20%; margin-left:0;"></hr><br><i>Ermişler</i><br><i>Sözlük</i>
Hortum Tanrıça	<b>Hortum Tanrıça</b><br><br><hr style="border: 7px solid green; width:20%; margin-left:0;"></hr><br><i>Ermişler</i><br><i>Sözlük</i>
Jhess	<b>Jhess</b><br>Örgünün Kraliçesi<br><hr style="border: 7px solid green; width:20%; margin-left:0;"></hr><br><i>Ermişler</i><br><i>Sözlük</i>
K'rul	<b>K'rul</b><br>bir Kovanlar Ata Tanrısı<br><hr style="border: 7px solid green; width:20%; margin-left:0;"></hr><br><i>Ermişler</i><br><i>Sözlük</i>
Mael	<b>Mael</b><br>bir Denizler Ata Tanrısı<br><hr style="border: 7px solid green; width:20%; margin-left:0;"></hr><br><i>Ermişler</i><br><i>Sözlük</i>
Mowri	<b>Mowri</b><br>Dilenciler, Köleler ve Irgatlar Leydisi<br><hr style="border: 7px solid green; width:20%; margin-left:0;"></hr><br><i>Ermişler</i><br><i>Sözlük</i>
Nerruse	<b>Nerruse</b><br>Sakin Denizler ve Uygun Rüzgârlar Leydisi<br><hr style="border: 7px solid green; width:20%; margin-left:0;"></hr><br><i>Ermişler</i><br><i>Sözlük</i>
Oponn	<b>Oponn</b><br>Şansın İkiz Maskaraları<br><hr style="border: 7px solid green; width:20%; margin-left:0;"></hr><br><i>Ermişler</i><br><i>Sözlük</i>
Osserc/Osseric/Osric	<b>Osserc/Osseric/Osric</b><br>Göğün Lordu<br><hr style="border: 7px solid green; width:20%; margin-left:0;"></hr><br><i>Ermişler</i><br><i>Sözlük</i>
Poliel	<b>Poliel</b><br>Salgınlar ve Hastalıklar Hanımı<br><hr style="border: 7px solid green; width:20%; margin-left:0;"></hr><br><i>Ermişler</i><br><i>Sözlük</i>
Sakat Tanrı	<b>Sakat Tanrı</b><br>Zincire Vurulmuş, Zincirler Üst Hanesi Lordu<br><hr style="border: 7px solid green; width:20%; margin-left:0;"></hr><br><i>Ermişler</i><br><i>Sözlük</i>
Soğuk Geceler Bacısı	<b>Soğuk Geceler Bacısı</b><br>bir Ata Tanrıça<br><hr style="border: 7px solid green; width:20%; margin-left:0;"></hr><br><i>Ermişler</i><br><i>Sözlük</i>
Soliel	<b>Soliel</b><br>Sıhhat Leydisi<br><hr style="border: 7px solid green; width:20%; margin-left:0;"></hr><br><i>Ermişler</i><br><i>Sözlük</i>
Togg ve Fanderay	<b>Togg ve Fanderay</b><br>Kış Kurtları<br><hr style="border: 7px solid green; width:20%; margin-left:0;"></hr><br><i>Ermişler</i><br><i>Sözlük</i>
Treach/Trake	<b>Treach/Trake</b><br>Yaz Kaplanı ve Savaş Lordu<br><hr style="border: 7px solid green; width:20%; margin-left:0;"></hr><br><i>Ermişler</i><br><i>Sözlük</i>
Örülü Urugal	<b>Örülü Urugal</b><br><br><hr style="border: 7px solid green; width:20%; margin-left:0;"></hr><br><i>Teblor Tanrıları (Kayadaki Yedi Surat)</i><br><i>Sözlük</i>
Bulunmamış ‘Siballe	<b>Bulunmamış ‘Siballe</b><br><br><hr style="border: 7px solid green; width:20%; margin-left:0;"></hr><br><i>Teblor Tanrıları (Kayadaki Yedi Surat)</i><br><i>Sözlük</i>
Yumuşak Sesli Beroke	<b>Yumuşak Sesli Beroke</b><br><br><hr style="border: 7px solid green; width:20%; margin-left:0;"></hr><br><i>Teblor Tanrıları (Kayadaki Yedi Surat)</i><br><i>Sözlük</i>
Sessiz Avcı Kahlb	<b>Sessiz Avcı Kahlb</b><br><br><hr style="border: 7px solid green; width:20%; margin-left:0;"></hr><br><i>Teblor Tanrıları (Kayadaki Yedi Surat)</i><br><i>Sözlük</i>
Binbir Parça Thenik	<b>Binbir Parça Thenik</b><br><br><hr style="border: 7px solid green; width:20%; margin-left:0;"></hr><br><i>Teblor Tanrıları (Kayadaki Yedi Surat)</i><br><i>Sözlük</i>
Dev Halad	<b>Dev Halad</b><br><br><hr style="border: 7px solid green; width:20%; margin-left:0;"></hr><br><i>Teblor Tanrıları (Kayadaki Yedi Surat)</i><br><i>Sözlük</i>
Zalim Imroth	<b>Zalim Imroth</b><br><br><hr style="border: 7px solid green; width:20%; margin-left:0;"></hr><br><i>Teblor Tanrıları (Kayadaki Yedi Surat)</i><br><i>Sözlük</i>
Tiste Andiiler	<b>Tiste Andiiler</b><br>Karanlığın Çocukları<br><hr style="border: 7px solid green; width:20%; margin-left:0;"></hr><br><i>Ata Halklar</i><br><i>Sözlük</i>
Tiste Edurlar	<b>Tiste Edurlar</b><br>Gölgenin Çocukları<br><hr style="border: 7px solid green; width:20%; margin-left:0;"></hr><br><i>Ata Halklar</i><br><i>Sözlük</i>
Tiste Liosanlar	<b>Tiste Liosanlar</b><br>Işığın Çocukları<br><hr style="border: 7px solid green; width:20%; margin-left:0;"></hr><br><i>Ata Halklar</i><br><i>Sözlük</i>
T'lan Imasslar	<b>T'lan Imasslar</b><br><br><hr style="border: 7px solid green; width:20%; margin-left:0;"></hr><br><i>Ata Halklar</i><br><i>Sözlük</i>
Eresler/Eres'allar	<b>Eresler/Eres'allar</b><br><br><hr style="border: 7px solid green; width:20%; margin-left:0;"></hr><br><i>Ata Halklar</i><br><i>Sözlük</i>
Trell'ler	<b>Trell'ler</b><br><br><hr style="border: 7px solid green; width:20%; margin-left:0;"></hr><br><i>Ata Halklar</i><br><i>Sözlük</i>
Jaghutlar	<b>Jaghutlar</b><br><br><hr style="border: 7px solid green; width:20%; margin-left:0;"></hr><br><i>Ata Halklar</i><br><i>Sözlük</i>
Forkrul Assailler	<b>Forkrul Assailler</b><br><br><hr style="border: 7px solid green; width:20%; margin-left:0;"></hr><br><i>Ata Halklar</i><br><i>Sözlük</i>
K'Chain Che'Malleler	<b>K'Chain Che'Malleler</b><br><br><hr style="border: 7px solid green; width:20%; margin-left:0;"></hr><br><i>Ata Halklar</i><br><i>Sözlük</i>
Eleintler	<b>Eleintler</b><br><br><hr style="border: 7px solid green; width:20%; margin-left:0;"></hr><br><i>Ata Halklar</i><br><i>Sözlük</i>
Barghastlar	<b>Barghastlar</b><br><br><hr style="border: 7px solid green; width:20%; margin-left:0;"></hr><br><i>Ata Halklar</i><br><i>Sözlük</i>
Thelomen Toblakailer	<b>Thelomen Toblakailer</b><br><br><hr style="border: 7px solid green; width:20%; margin-left:0;"></hr><br><i>Ata Halklar</i><br><i>Sözlük</i>
Teblorlar	<b>Teblorlar</b><br><br><hr style="border: 7px solid green; width:20%; margin-left:0;"></hr><br><i>Ata Halklar</i><br><i>Sözlük</i>
Kurald Galain	<b>Kurald Galain</b><br>Karanlığın Ata Kovanı<br><hr style="border: 7px solid green; width:20%; margin-left:0;"></hr><br><i>Kovanlar</i><br><i>Sözlük</i>
Kurald Emurlahn	<b>Kurald Emurlahn</b><br>Gölgenin Ata Kovanı, Kırık Kovan<br><hr style="border: 7px solid green; width:20%; margin-left:0;"></hr><br><i>Kovanlar</i><br><i>Sözlük</i>
Kurald Thyrllan	<b>Kurald Thyrllan</b><br>Işığın Ata Kovanı<br><hr style="border: 7px solid green; width:20%; margin-left:0;"></hr><br><i>Kovanlar</i><br><i>Sözlük</i>
Omtose Phellack	<b>Omtose Phellack</b><br>Buzun Jaghut Ata Kovanı<br><hr style="border: 7px solid green; width:20%; margin-left:0;"></hr><br><i>Kovanlar</i><br><i>Sözlük</i>
Tellann	<b>Tellann</b><br>Ateşin Imass Ata Kovanı<br><hr style="border: 7px solid green; width:20%; margin-left:0;"></hr><br><i>Kovanlar</i><br><i>Sözlük</i>
Starvald Demelain	<b>Starvald Demelain</b><br>Eleint Kovanı<br><hr style="border: 7px solid green; width:20%; margin-left:0;"></hr><br><i>Kovanlar</i><br><i>Sözlük</i>
Thyr	<b>Thyr</b><br>Işığın Yolu<br><hr style="border: 7px solid green; width:20%; margin-left:0;"></hr><br><i>Kovanlar</i><br><i>Sözlük</i>
Denul	<b>Denul</b><br>Şifanın Yolu<br><hr style="border: 7px solid green; width:20%; margin-left:0;"></hr><br><i>Kovanlar</i><br><i>Sözlük</i>
Hood'un Yolu	<b>Hood'un Yolu</b><br>Ölümün Yolu<br><hr style="border: 7px solid green; width:20%; margin-left:0;"></hr><br><i>Kovanlar</i><br><i>Sözlük</i>
Serc	<b>Serc</b><br>Göğün Yolu<br><hr style="border: 7px solid green; width:20%; margin-left:0;"></hr><br><i>Kovanlar</i><br><i>Sözlük</i>
Meanas	<b>Meanas</b><br>Gölgenin ve İllüzyonun Yolu<br><hr style="border: 7px solid green; width:20%; margin-left:0;"></hr><br><i>Kovanlar</i><br><i>Sözlük</i>
D'riss	<b>D'riss</b><br>Toprağın Yolu<br><hr style="border: 7px solid green; width:20%; margin-left:0;"></hr><br><i>Kovanlar</i><br><i>Sözlük</i>
Ruse	<b>Ruse</b><br>Denizin Yolu<br><hr style="border: 7px solid green; width:20%; margin-left:0;"></hr><br><i>Kovanlar</i><br><i>Sözlük</i>
Rashan	<b>Rashan</b><br>Karanlığın Yolu<br><hr style="border: 7px solid green; width:20%; margin-left:0;"></hr><br><i>Kovanlar</i><br><i>Sözlük</i>
Mockra	<b>Mockra</b><br>Zihnin Yolu<br><hr style="border: 7px solid green; width:20%; margin-left:0;"></hr><br><i>Kovanlar</i><br><i>Sözlük</i>
Telas	<b>Telas</b><br>Ateşin Yolu<br><hr style="border: 7px solid green; width:20%; margin-left:0;"></hr><br><i>Kovanlar</i><br><i>Sözlük</i>
Aren	<b>Aren</b><br>bir Kutsal Şehir<br><hr style="border: 7px solid green; width:20%; margin-left:0;"></hr><br><i>Yedi Kent</i><br><i>Zincirler Hanesi'nde Yerler</i><br><i>Sözlük</i>
Balahn	<b>Balahn</b><br>Aren'in kuzeyindeki küçük bir köy<br><hr style="border: 7px solid green; width:20%; margin-left:0;"></hr><br><i>Yedi Kent</i><br><i>Zincirler Hanesi'nde Yerler</i><br><i>Sözlük</i>
Ehrlitan	<b>Ehrlitan</b><br>Raraku'nun kuzeyindeki bir Kutsal Şehir<br><hr style="border: 7px solid green; width:20%; margin-left:0;"></hr><br><i>Yedi Kent</i><br><i>Zincirler Hanesi'nde Yerler</i><br><i>Sözlük</i>
Erougimon	<b>Erougimon</b><br>Aren'in kuzeyindeki bir tal<br><hr style="border: 7px solid green; width:20%; margin-left:0;"></hr><br><i>Yedi Kent</i><br><i>Zincirler Hanesi'nde Yerler</i><br><i>Sözlük</i>
G'danisban	<b>G'danisban</b><br>Raraku'nun doğusundaki bir şehir<br><hr style="border: 7px solid green; width:20%; margin-left:0;"></hr><br><i>Yedi Kent</i><br><i>Zincirler Hanesi'nde Yerler</i><br><i>Sözlük</i>
Jhag Odhan	<b>Jhag Odhan</b><br>Yedi Kent'in batısındaki sahralar<br><hr style="border: 7px solid green; width:20%; margin-left:0;"></hr><br><i>Yedi Kent</i><br><i>Zincirler Hanesi'nde Yerler</i><br><i>Sözlük</i>
Lato Revae	<b>Lato Revae</b><br>Raraku'nun batısındaki bir şehir<br><hr style="border: 7px solid green; width:20%; margin-left:0;"></hr><br><i>Yedi Kent</i><br><i>Zincirler Hanesi'nde Yerler</i><br><i>Sözlük</i>
Sarpachiya	<b>Sarpachiya</b><br>Raraku'nun batısındaki bir şehir<br><hr style="border: 7px solid green; width:20%; margin-left:0;"></hr><br><i>Yedi Kent</i><br><i>Zincirler Hanesi'nde Yerler</i><br><i>Sözlük</i>
Thalas Nehri	<b>Thalas Nehri</b><br>Raraku'nun batısı<br><hr style="border: 7px solid green; width:20%; margin-left:0;"></hr><br><i>Yedi Kent</i><br><i>Zincirler Hanesi'nde Yerler</i><br><i>Sözlük</i>
Vaha	<b>Vaha</b><br>Kutsal Raraku Çölü<br><hr style="border: 7px solid green; width:20%; margin-left:0;"></hr><br><i>Yedi Kent</i><br><i>Zincirler Hanesi'nde Yerler</i><br><i>Sözlük</i>
Vathar Geçişi	<b>Vathar Geçişi</b><br>Köpekler Zinciri'nde bir muharebe alanı<br><hr style="border: 7px solid green; width:20%; margin-left:0;"></hr><br><i>Yedi Kent</i><br><i>Zincirler Hanesi'nde Yerler</i><br><i>Sözlük</i>
Y'Ghatan	<b>Y'Ghatan</b><br>sözde ilk Kutsal Şehir<br><hr style="border: 7px solid green; width:20%; margin-left:0;"></hr><br><i>Yedi Kent</i><br><i>Zincirler Hanesi'nde Yerler</i><br><i>Sözlük</i>
Culvern	<b>Culvern</b><br>bir kasaba<br><hr style="border: 7px solid green; width:20%; margin-left:0;"></hr><br><i>Genabackis</i><br><i>Zincirler Hanesi'nde Yerler</i><br><i>Sözlük</i>
Genabaris	<b>Genabaris</b><br>bir şehir<br><hr style="border: 7px solid green; width:20%; margin-left:0;"></hr><br><i>Genabackis</i><br><i>Zincirler Hanesi'nde Yerler</i><br><i>Sözlük</i>
Malybridge	<b>Malybridge</b><br>bir kasaba<br><hr style="border: 7px solid green; width:20%; margin-left:0;"></hr><br><i>Genabackis</i><br><i>Zincirler Hanesi'nde Yerler</i><br><i>Sözlük</i>
Malyntaeas	<b>Malyntaeas</b><br>bir şehir<br><hr style="border: 7px solid green; width:20%; margin-left:0;"></hr><br><i>Genabackis</i><br><i>Zincirler Hanesi'nde Yerler</i><br><i>Sözlük</i>
Ninsano Hendeği	<b>Ninsano Hendeği</b><br>bir kasaba<br><hr style="border: 7px solid green; width:20%; margin-left:0;"></hr><br><i>Genabackis</i><br><i>Zincirler Hanesi'nde Yerler</i><br><i>Sözlük</i>
Tanys	<b>Tanys</b><br>bir kasaba<br><hr style="border: 7px solid green; width:20%; margin-left:0;"></hr><br><i>Genabackis</i><br><i>Zincirler Hanesi'nde Yerler</i><br><i>Sözlük</i>
Drift Avalii	<b>Drift Avalii</b><br>Quon Tali kıtasının güneybatısındaki bir ada<br><hr style="border: 7px solid green; width:20%; margin-left:0;"></hr><br><i>Sözlük</i>
Doğuş	<b>Doğuş</b><br>sel basmış bir dünya<br><hr style="border: 7px solid green; width:20%; margin-left:0;"></hr><br><i>Sözlük</i>
